Path;File;Number of lines;Changed Lines;Lines added;Lines removed;Number of contributers;Number of contributions;Number of fixes;Number of non fixes
E:\workspace\java\hibernate-orm\hibernate-core\src\main\java\org\hibernate\persister\entity\AbstractEntityPersister.java;AbstractEntityPersister.java;5954;940;638;302;7;44;11;33
E:\workspace\java\hibernate-orm\hibernate-core\src\main\java\org\hibernate\boot\model\source\internal\hbm\ModelBinder.java;ModelBinder.java;4280;540;229;311;6;14;1;13
E:\workspace\java\hibernate-orm\hibernate-core\src\main\java\org\hibernate\internal\SessionImpl.java;SessionImpl.java;3797;1400;635;765;8;52;2;50
E:\workspace\java\hibernate-orm\hibernate-core\src\main\java\org\hibernate\cfg\AnnotationBinder.java;AnnotationBinder.java;3585;380;251;129;5;13;1;12
E:\workspace\java\hibernate-orm\hibernate-core\src\main\java\org\hibernate\cfg\annotations\reflection\JPAOverriddenAnnotationReader.java;JPAOverriddenAnnotationReader.java;3079;181;97;84;2;3;0;3
E:\workspace\java\hibernate-orm\hibernate-core\src\main\java\org\hibernate\dialect\Dialect.java;Dialect.java;3051;187;120;67;4;9;1;8
E:\workspace\java\hibernate-orm\hibernate-core\src\main\java\org\hibernate\loader\Loader.java;Loader.java;3008;267;193;74;3;12;1;11
E:\workspace\java\hibernate-orm\hibernate-core\src\main\java\org\hibernate\internal\util\collections\BoundedConcurrentHashMap.java;BoundedConcurrentHashMap.java;2472;6;2;4;1;1;0;1
E:\workspace\java\hibernate-orm\hibernate-core\src\main\java\org\hibernate\boot\internal\InFlightMetadataCollectorImpl.java;InFlightMetadataCollectorImpl.java;2334;374;205;169;4;15;1;14
E:\workspace\java\hibernate-orm\hibernate-core\src\main\java\org\hibernate\persister\collection\AbstractCollectionPersister.java;AbstractCollectionPersister.java;2277;135;78;57;4;10;0;10
E:\workspace\java\hibernate-orm\hibernate-core\src\main\java\org\hibernate\engine\internal\StatefulPersistenceContext.java;StatefulPersistenceContext.java;2198;614;387;227;5;23;1;22
E:\workspace\java\hibernate-orm\hibernate-core\src\main\java\org\hibernate\cfg\AvailableSettings.java;AvailableSettings.java;2078;321;290;31;7;28;1;27
E:\workspace\java\hibernate-orm\hibernate-core\src\main\java\org\hibernate\internal\CoreMessageLogger.java;CoreMessageLogger.java;1879;176;135;41;6;31;2;29
E:\workspace\java\hibernate-orm\hibernate-core\src\main\java\org\hibernate\cfg\annotations\CollectionBinder.java;CollectionBinder.java;1819;253;167;86;5;9;0;9
E:\workspace\java\hibernate-orm\hibernate-core\src\main\java\org\hibernate\query\internal\AbstractProducedQuery.java;AbstractProducedQuery.java;1681;156;83;73;8;18;3;15
E:\workspace\java\hibernate-orm\hibernate-core\src\main\java\org\hibernate\internal\SessionFactoryImpl.java;SessionFactoryImpl.java;1677;370;213;157;3;24;0;24
E:\workspace\java\hibernate-orm\hibernate-core\src\main\java\org\hibernate\dialect\AbstractHANADialect.java;AbstractHANADialect.java;1666;314;211;103;5;21;3;18
E:\workspace\java\hibernate-orm\hibernate-core\src\main\java\org\hibernate\Query.java;Query.java;1622;113;107;6;2;4;0;4
E:\workspace\java\hibernate-orm\hibernate-core\src\main\java\org\hibernate\hql\internal\ast\HqlSqlWalker.java;HqlSqlWalker.java;1487;16;10;6;2;2;0;2
E:\workspace\java\hibernate-orm\hibernate-core\src\main\java\org\hibernate\boot\internal\SessionFactoryOptionsBuilder.java;SessionFactoryOptionsBuilder.java;1381;1583;1482;101;5;22;1;21
E:\workspace\java\hibernate-orm\hibernate-core\src\main\java\org\hibernate\hql\internal\classic\QueryTranslatorImpl.java;QueryTranslatorImpl.java;1376;41;26;15;4;7;0;7
E:\workspace\java\hibernate-orm\hibernate-core\src\main\java\org\hibernate\collection\internal\AbstractPersistentCollection.java;AbstractPersistentCollection.java;1362;173;121;52;4;10;1;9
E:\workspace\java\hibernate-orm\hibernate-core\src\main\java\org\hibernate\engine\spi\ActionQueue.java;ActionQueue.java;1362;308;184;124;4;11;3;8
E:\workspace\java\hibernate-orm\hibernate-core\src\main\java\org\hibernate\cfg\annotations\EntityBinder.java;EntityBinder.java;1329;70;32;38;3;4;0;4
E:\workspace\java\hibernate-orm\hibernate-core\src\main\java\org\hibernate\engine\spi\SessionDelegatorBaseImpl.java;SessionDelegatorBaseImpl.java;1237;40;34;6;4;7;1;6
E:\workspace\java\hibernate-orm\hibernate-core\src\main\java\org\hibernate\internal\AbstractSharedSessionContract.java;AbstractSharedSessionContract.java;1221;456;291;165;8;25;1;24
E:\workspace\java\hibernate-orm\hibernate-core\src\main\java\org\hibernate\Session.java;Session.java;1184;51;39;12;4;7;3;4
E:\workspace\java\hibernate-orm\hibernate-core\src\main\java\org\hibernate\cfg\BinderHelper.java;BinderHelper.java;1144;51;27;24;3;6;2;4
E:\workspace\java\hibernate-orm\hibernate-core\src\main\java\org\hibernate\query\Query.java;Query.java;1142;95;57;38;4;6;0;6
E:\workspace\java\hibernate-orm\hibernate-core\src\main\java\org\hibernate\persister\entity\JoinedSubclassEntityPersister.java;JoinedSubclassEntityPersister.java;1127;138;69;69;4;8;2;6
E:\workspace\java\hibernate-orm\hibernate-envers\src\main\java\org\hibernate\envers\configuration\internal\metadata\CollectionMetadataGenerator.java;CollectionMetadataGenerator.java;1117;92;64;28;3;7;3;4
E:\workspace\java\hibernate-orm\hibernate-core\src\main\java\org\hibernate\metamodel\internal\AttributeFactory.java;AttributeFactory.java;1073;289;144;145;2;3;0;3
E:\workspace\java\hibernate-orm\hibernate-core\src\main\java\org\hibernate\jpa\boot\internal\EntityManagerFactoryBuilderImpl.java;EntityManagerFactoryBuilderImpl.java;1054;110;76;34;3;6;1;5
E:\workspace\java\hibernate-orm\hibernate-core\src\main\java\org\hibernate\tuple\entity\EntityMetamodel.java;EntityMetamodel.java;1048;205;74;131;3;7;1;6
E:\workspace\java\hibernate-orm\hibernate-core\src\main\java\org\hibernate\mapping\PersistentClass.java;PersistentClass.java;1011;36;18;18;3;4;1;3
E:\workspace\java\hibernate-orm\hibernate-core\src\main\java\org\hibernate\stat\internal\StatisticsImpl.java;StatisticsImpl.java;992;760;409;351;4;12;1;11
E:\workspace\java\hibernate-orm\hibernate-core\src\main\java\org\hibernate\cfg\Ejb3JoinColumn.java;Ejb3JoinColumn.java;985;10;3;7;1;3;0;3
E:\workspace\java\hibernate-orm\hibernate-core\src\main\java\org\hibernate\boot\internal\MetadataBuilderImpl.java;MetadataBuilderImpl.java;942;391;168;223;2;6;0;6
E:\workspace\java\hibernate-orm\hibernate-core\src\main\java\org\hibernate\engine\spi\PersistenceContext.java;PersistenceContext.java;935;253;154;99;3;5;0;5
E:\workspace\java\hibernate-orm\hibernate-core\src\main\java\org\hibernate\tool\schema\extract\internal\InformationExtractorJdbcDatabaseMetaDataImpl.java;InformationExtractorJdbcDatabaseMetaDataImpl.java;927;18;11;7;2;4;1;3
E:\workspace\java\hibernate-orm\hibernate-core\src\main\java\org\hibernate\loader\plan\build\internal\AbstractLoadPlanBuildingAssociationVisitationStrategy.java;AbstractLoadPlanBuildingAssociationVisitationStrategy.java;922;4;0;4;1;1;0;1
E:\workspace\java\hibernate-orm\hibernate-core\src\main\java\org\hibernate\procedure\internal\ProcedureCallImpl.java;ProcedureCallImpl.java;921;6;2;4;1;1;0;1
E:\workspace\java\hibernate-orm\hibernate-core\src\main\java\org\hibernate\mapping\Table.java;Table.java;913;37;12;25;2;2;0;2
E:\workspace\java\hibernate-orm\hibernate-core\src\main\java\org\hibernate\type\CollectionType.java;CollectionType.java;889;166;113;53;6;14;3;11
E:\workspace\java\hibernate-orm\hibernate-core\src\main\java\org\hibernate\internal\util\StringHelper.java;StringHelper.java;863;354;177;177;5;19;2;17
E:\workspace\java\hibernate-orm\hibernate-core\src\main\java\org\hibernate\cfg\Configuration.java;Configuration.java;861;2;0;2;1;1;0;1
E:\workspace\java\hibernate-orm\hibernate-core\src\main\java\org\hibernate\query\criteria\internal\compile\CriteriaQueryTypeQueryAdapter.java;CriteriaQueryTypeQueryAdapter.java;860;177;99;78;3;5;2;3
E:\workspace\java\hibernate-orm\hibernate-core\src\main\java\org\hibernate\persister\entity\SingleTableEntityPersister.java;SingleTableEntityPersister.java;850;46;22;24;3;5;0;5
E:\workspace\java\hibernate-orm\hibernate-core\src\main\java\org\hibernate\type\ComponentType.java;ComponentType.java;849;13;10;3;1;2;0;2
E:\workspace\java\hibernate-orm\hibernate-core\src\main\java\org\hibernate\persister\entity\EntityPersister.java;EntityPersister.java;842;47;38;9;3;4;1;3
E:\workspace\java\hibernate-orm\hibernate-core\src\main\java\org\hibernate\metamodel\internal\MetamodelImpl.java;MetamodelImpl.java;842;490;310;180;4;17;1;16
E:\workspace\java\hibernate-orm\hibernate-core\src\main\java\org\hibernate\query\internal\NativeQueryImpl.java;NativeQueryImpl.java;839;23;19;4;3;3;0;3
E:\workspace\java\hibernate-orm\hibernate-core\src\main\java\org\hibernate\mapping\SimpleValue.java;SimpleValue.java;828;175;118;57;3;9;1;8
E:\workspace\java\hibernate-orm\hibernate-core\src\main\java\org\hibernate\hql\internal\ast\tree\DotNode.java;DotNode.java;824;137;98;39;4;6;1;5
E:\workspace\java\hibernate-orm\hibernate-envers\src\main\java\org\hibernate\envers\configuration\internal\metadata\reader\AuditedPropertiesReader.java;AuditedPropertiesReader.java;823;90;53;37;2;3;1;2
E:\workspace\java\hibernate-orm\hibernate-core\src\main\java\org\hibernate\cfg\annotations\TableBinder.java;TableBinder.java;817;15;2;13;1;1;0;1
E:\workspace\java\hibernate-orm\hibernate-envers\src\main\java\org\hibernate\envers\configuration\internal\metadata\AuditMetadataGenerator.java;AuditMetadataGenerator.java;812;63;15;48;2;4;0;4
E:\workspace\java\hibernate-orm\hibernate-core\src\main\java\org\hibernate\cfg\Ejb3Column.java;Ejb3Column.java;783;17;12;5;2;2;0;2
E:\workspace\java\hibernate-orm\hibernate-core\src\main\java\org\hibernate\sql\Template.java;Template.java;777;12;11;1;2;2;0;2
E:\workspace\java\hibernate-orm\hibernate-core\src\main\java\org\hibernate\boot\SessionFactoryBuilder.java;SessionFactoryBuilder.java;772;28;20;8;1;5;0;5
E:\workspace\java\hibernate-orm\hibernate-core\src\main\java\org\hibernate\dialect\Oracle8iDialect.java;Oracle8iDialect.java;769;25;17;8;2;4;0;4
E:\workspace\java\hibernate-orm\hibernate-core\src\main\java\org\hibernate\type\EntityType.java;EntityType.java;768;95;76;19;5;10;0;10
E:\workspace\java\hibernate-orm\hibernate-core\src\main\java\org\hibernate\tuple\entity\AbstractEntityTuplizer.java;AbstractEntityTuplizer.java;761;64;39;25;2;3;0;3
E:\workspace\java\hibernate-orm\hibernate-core\src\main\java\org\hibernate\internal\StatelessSessionImpl.java;StatelessSessionImpl.java;749;136;104;32;3;7;0;7
E:\workspace\java\hibernate-orm\hibernate-core\src\main\java\org\hibernate\loader\plan\exec\internal\LoadQueryJoinAndFetchProcessor.java;LoadQueryJoinAndFetchProcessor.java;742;214;119;95;3;4;0;4
E:\workspace\java\hibernate-orm\hibernate-core\src\main\java\org\hibernate\criterion\Property.java;Property.java;741;24;12;12;1;1;1;0
E:\workspace\java\hibernate-orm\hibernate-core\src\main\java\org\hibernate\bytecode\enhance\internal\javassist\PersistentAttributesEnhancer.java;PersistentAttributesEnhancer.java;740;7;5;2;2;2;0;2
E:\workspace\java\hibernate-orm\hibernate-core\src\main\java\org\hibernate\event\internal\DefaultFlushEntityEventListener.java;DefaultFlushEntityEventListener.java;731;148;98;50;5;10;0;10
E:\workspace\java\hibernate-orm\hibernate-core\src\main\java\org\hibernate\hql\internal\ast\tree\FromElement.java;FromElement.java;730;70;38;32;5;10;2;8
E:\workspace\java\hibernate-orm\hibernate-core\src\main\java\org\hibernate\internal\CriteriaImpl.java;CriteriaImpl.java;730;2;1;1;1;1;0;1
E:\workspace\java\hibernate-orm\hibernate-core\src\main\java\org\hibernate\hql\internal\ast\tree\FromElementType.java;FromElementType.java;729;81;58;23;5;5;0;5
E:\workspace\java\hibernate-orm\hibernate-core\src\main\java\org\hibernate\mapping\Collection.java;Collection.java;710;56;44;12;3;7;1;6
E:\workspace\java\hibernate-orm\hibernate-core\src\main\java\org\hibernate\dialect\HSQLDialect.java;HSQLDialect.java;706;31;29;2;2;2;1;1
E:\workspace\java\hibernate-orm\hibernate-core\src\main\java\org\hibernate\internal\util\ReflectHelper.java;ReflectHelper.java;697;320;160;160;4;5;0;5
E:\workspace\java\hibernate-orm\hibernate-core\src\main\java\org\hibernate\loader\criteria\CriteriaQueryTranslator.java;CriteriaQueryTranslator.java;697;32;25;7;2;2;1;1
E:\workspace\java\hibernate-orm\hibernate-core\src\main\java\org\hibernate\engine\internal\JoinSequence.java;JoinSequence.java;684;95;76;19;3;4;1;3
E:\workspace\java\hibernate-orm\hibernate-core\src\main\java\org\hibernate\engine\spi\QueryParameters.java;QueryParameters.java;683;21;18;3;2;2;0;2
E:\workspace\java\hibernate-orm\hibernate-core\src\main\java\org\hibernate\dialect\Cache71Dialect.java;Cache71Dialect.java;678;5;2;3;1;1;0;1
E:\workspace\java\hibernate-orm\hibernate-core\src\main\java\org\hibernate\hql\internal\ast\QueryTranslatorImpl.java;QueryTranslatorImpl.java;669;27;20;7;3;4;0;4
E:\workspace\java\hibernate-orm\hibernate-core\src\main\java\org\hibernate\query\internal\QueryParameterBindingsImpl.java;QueryParameterBindingsImpl.java;667;122;90;32;3;5;0;5
E:\workspace\java\hibernate-orm\hibernate-core\src\main\java\org\hibernate\loader\hql\QueryLoader.java;QueryLoader.java;652;11;7;4;2;3;1;2
E:\workspace\java\hibernate-orm\hibernate-core\src\main\java\org\hibernate\collection\internal\PersistentBag.java;PersistentBag.java;649;162;125;37;5;7;0;7
E:\workspace\java\hibernate-orm\hibernate-core\src\main\java\org\hibernate\engine\internal\AbstractEntityEntry.java;AbstractEntityEntry.java;649;17;15;2;3;3;0;3
E:\workspace\java\hibernate-orm\hibernate-core\src\main\java\org\hibernate\dialect\PostgreSQL81Dialect.java;PostgreSQL81Dialect.java;646;15;13;2;2;4;0;4
E:\workspace\java\hibernate-orm\hibernate-core\src\main\java\org\hibernate\collection\internal\PersistentMap.java;PersistentMap.java;638;27;27;0;2;2;0;2
E:\workspace\java\hibernate-orm\hibernate-core\src\main\java\org\hibernate\tool\schema\internal\SchemaCreatorImpl.java;SchemaCreatorImpl.java;627;7;4;3;2;3;0;3
E:\workspace\java\hibernate-orm\hibernate-core\src\main\java\org\hibernate\cache\internal\EnabledCaching.java;EnabledCaching.java;618;736;677;59;4;7;0;7
E:\workspace\java\hibernate-orm\tooling\metamodel-generator\src\main\java\org\hibernate\jpamodelgen\xml\XmlMetaEntity.java;XmlMetaEntity.java;614;2;1;1;1;1;0;1
E:\workspace\java\hibernate-orm\hibernate-core\src\main\java\org\hibernate\dialect\pagination\SQLServer2005LimitHandler.java;SQLServer2005LimitHandler.java;613;211;186;25;3;3;0;3
E:\workspace\java\hibernate-orm\hibernate-core\src\main\java\org\hibernate\dialect\DerbyDialect.java;DerbyDialect.java;611;15;14;1;1;1;0;1
E:\workspace\java\hibernate-orm\hibernate-core\src\main\java\org\hibernate\collection\internal\PersistentList.java;PersistentList.java;609;39;34;5;3;3;1;2
E:\workspace\java\hibernate-orm\hibernate-core\src\main\java\org\hibernate\dialect\MySQLDialect.java;MySQLDialect.java;606;35;25;10;2;4;0;4
E:\workspace\java\hibernate-orm\hibernate-core\src\main\java\org\hibernate\tool\hbm2ddl\SchemaExport.java;SchemaExport.java;606;5;1;4;2;2;0;2
E:\workspace\java\hibernate-orm\hibernate-core\src\main\java\org\hibernate\persister\collection\OneToManyPersister.java;OneToManyPersister.java;602;4;2;2;1;1;0;1
E:\workspace\java\hibernate-orm\hibernate-core\src\main\java\org\hibernate\tool\schema\internal\SchemaDropperImpl.java;SchemaDropperImpl.java;594;2;1;1;1;1;0;1
E:\workspace\java\hibernate-orm\hibernate-core\src\main\java\org\hibernate\dialect\DB2Dialect.java;DB2Dialect.java;594;44;33;11;3;3;0;3
E:\workspace\java\hibernate-orm\hibernate-core\src\main\java\org\hibernate\query\criteria\internal\path\AbstractFromImpl.java;AbstractFromImpl.java;592;7;1;6;1;1;0;1
E:\workspace\java\hibernate-orm\hibernate-core\src\main\java\org\hibernate\engine\internal\Cascade.java;Cascade.java;591;77;49;28;3;3;0;3
E:\workspace\java\hibernate-orm\hibernate-core\src\main\java\org\hibernate\id\enhanced\SequenceStyleGenerator.java;SequenceStyleGenerator.java;588;90;77;13;1;3;1;2
E:\workspace\java\hibernate-orm\hibernate-core\src\main\java\org\hibernate\event\internal\DefaultLoadEventListener.java;DefaultLoadEventListener.java;585;769;217;552;5;12;0;12
E:\workspace\java\hibernate-orm\hibernate-core\src\main\java\org\hibernate\tool\schema\internal\AbstractSchemaMigrator.java;AbstractSchemaMigrator.java;584;18;4;14;2;2;1;1
E:\workspace\java\hibernate-orm\hibernate-core\src\main\java\org\hibernate\bytecode\enhance\internal\bytebuddy\EnhancerImpl.java;EnhancerImpl.java;578;546;337;209;4;20;0;20
E:\workspace\java\hibernate-orm\hibernate-core\src\main\java\org\hibernate\type\Type.java;Type.java;577;738;374;364;2;4;1;3
E:\workspace\java\hibernate-orm\hibernate-core\src\main\java\org\hibernate\loader\entity\DynamicBatchingEntityLoaderBuilder.java;DynamicBatchingEntityLoaderBuilder.java;577;133;99;34;3;4;0;4
E:\workspace\java\hibernate-orm\hibernate-core\src\main\java\org\hibernate\cfg\annotations\SimpleValueBinder.java;SimpleValueBinder.java;574;34;17;17;1;1;0;1
E:\workspace\java\hibernate-orm\hibernate-core\src\main\java\org\hibernate\event\internal\DefaultMergeEventListener.java;DefaultMergeEventListener.java;559;174;116;58;4;6;0;6
E:\workspace\java\hibernate-orm\hibernate-core\src\main\java\org\hibernate\cfg\annotations\MapBinder.java;MapBinder.java;559;12;6;6;1;1;0;1
E:\workspace\java\hibernate-orm\hibernate-core\src\main\java\org\hibernate\dialect\Database.java;Database.java;556;33;22;11;2;6;0;6
E:\workspace\java\hibernate-orm\hibernate-core\src\main\java\org\hibernate\loader\custom\CustomLoader.java;CustomLoader.java;551;8;4;4;1;2;0;2
E:\workspace\java\hibernate-orm\hibernate-core\src\main\java\org\hibernate\hql\internal\ast\tree\FromElementFactory.java;FromElementFactory.java;551;2;1;1;1;1;1;0
E:\workspace\java\hibernate-orm\hibernate-core\src\main\java\org\hibernate\engine\internal\TwoPhaseLoad.java;TwoPhaseLoad.java;547;358;254;104;4;13;0;13
E:\workspace\java\hibernate-orm\hibernate-core\src\main\java\org\hibernate\metamodel\model\domain\internal\AbstractManagedType.java;AbstractManagedType.java;547;651;599;52;2;3;0;3
E:\workspace\java\hibernate-orm\hibernate-core\src\main\java\org\hibernate\metamodel\internal\MetadataContext.java;MetadataContext.java;547;314;171;143;4;9;2;7
E:\workspace\java\hibernate-orm\hibernate-core\src\main\java\org\hibernate\jpa\boot\internal\PersistenceXmlParser.java;PersistenceXmlParser.java;536;260;87;173;4;8;0;8
E:\workspace\java\hibernate-orm\hibernate-core\src\main\java\org\hibernate\event\internal\AbstractSaveEventListener.java;AbstractSaveEventListener.java;536;158;88;70;5;7;1;6
E:\workspace\java\hibernate-orm\hibernate-core\src\main\java\org\hibernate\engine\spi\SharedSessionContractImplementor.java;SharedSessionContractImplementor.java;534;122;116;6;6;10;0;10
E:\workspace\java\hibernate-orm\hibernate-core\src\main\java\org\hibernate\engine\jdbc\connections\internal\ConnectionProviderInitiator.java;ConnectionProviderInitiator.java;533;128;114;14;2;3;0;3
E:\workspace\java\hibernate-orm\hibernate-core\src\main\java\org\hibernate\loader\plan\exec\process\internal\EntityReferenceInitializerImpl.java;EntityReferenceInitializerImpl.java;532;70;52;18;2;2;0;2
E:\workspace\java\hibernate-orm\hibernate-core\src\main\java\org\hibernate\event\service\internal\EventListenerRegistryImpl.java;EventListenerRegistryImpl.java;528;175;136;39;3;5;0;5
E:\workspace\java\hibernate-orm\hibernate-core\src\main\java\org\hibernate\type\AnyType.java;AnyType.java;523;16;9;7;2;2;0;2
E:\workspace\java\hibernate-orm\hibernate-core\src\main\java\org\hibernate\hql\internal\ast\HqlParser.java;HqlParser.java;522;8;2;6;1;1;0;1
E:\workspace\java\hibernate-orm\hibernate-core\src\main\java\org\hibernate\collection\internal\PersistentIdentifierBag.java;PersistentIdentifierBag.java;522;41;36;5;4;4;0;4
E:\workspace\java\hibernate-orm\hibernate-core\src\main\java\org\hibernate\hql\internal\ast\tree\SelectClause.java;SelectClause.java;521;5;3;2;2;2;1;1
E:\workspace\java\hibernate-orm\hibernate-core\src\main\java\org\hibernate\collection\internal\PersistentSet.java;PersistentSet.java;516;32;30;2;3;3;0;3
E:\workspace\java\hibernate-orm\hibernate-core\src\main\java\org\hibernate\cfg\AbstractPropertyHolder.java;AbstractPropertyHolder.java;513;4;2;2;1;1;0;1
E:\workspace\java\hibernate-orm\hibernate-core\src\main\java\org\hibernate\bytecode\enhance\internal\bytebuddy\CodeTemplates.java;CodeTemplates.java;513;83;42;41;2;3;2;1
E:\workspace\java\hibernate-orm\hibernate-core\src\main\java\org\hibernate\engine\jdbc\internal\JdbcCoordinatorImpl.java;JdbcCoordinatorImpl.java;510;72;23;49;2;5;0;5
E:\workspace\java\hibernate-orm\hibernate-core\src\main\java\org\hibernate\mapping\Component.java;Component.java;509;125;102;23;3;5;1;4
E:\workspace\java\hibernate-orm\hibernate-core\src\main\java\org\hibernate\engine\spi\CascadingActions.java;CascadingActions.java;502;27;13;14;3;5;0;5
E:\workspace\java\hibernate-orm\hibernate-core\src\main\java\org\hibernate\cfg\annotations\PropertyBinder.java;PropertyBinder.java;501;2;1;1;1;1;0;1
E:\workspace\java\hibernate-orm\hibernate-core\src\main\java\org\hibernate\tool\schema\spi\SchemaManagementToolCoordinator.java;SchemaManagementToolCoordinator.java;499;3;2;1;1;1;0;1
E:\workspace\java\hibernate-orm\hibernate-envers\src\main\java\org\hibernate\envers\strategy\internal\ValidityAuditStrategy.java;ValidityAuditStrategy.java;498;498;498;0;1;1;0;1
E:\workspace\java\hibernate-orm\hibernate-core\src\main\java\org\hibernate\cfg\CollectionPropertyHolder.java;CollectionPropertyHolder.java;498;4;2;2;1;1;0;1
E:\workspace\java\hibernate-orm\hibernate-core\src\main\java\org\hibernate\engine\internal\NaturalIdXrefDelegate.java;NaturalIdXrefDelegate.java;496;57;30;27;2;4;0;4
E:\workspace\java\hibernate-orm\hibernate-jipijapa\src\main\java\org\jboss\as\jpa\hibernate5\management\HibernateStatistics.java;HibernateStatistics.java;495;1395;945;450;1;2;0;2
E:\workspace\java\hibernate-orm\hibernate-core\src\main\java\org\hibernate\persister\entity\UnionSubclassEntityPersister.java;UnionSubclassEntityPersister.java;488;10;6;4;1;2;0;2
E:\workspace\java\hibernate-orm\hibernate-core\src\main\java\org\hibernate\loader\plan\exec\internal\AbstractLoadPlanBasedLoader.java;AbstractLoadPlanBasedLoader.java;484;57;14;43;3;7;0;7
E:\workspace\java\hibernate-orm\hibernate-core\src\main\java\org\hibernate\engine\spi\SessionFactoryDelegatingImpl.java;SessionFactoryDelegatingImpl.java;484;67;16;51;1;4;0;4
E:\workspace\java\hibernate-orm\hibernate-core\src\main\java\org\hibernate\boot\MetadataSources.java;MetadataSources.java;481;43;22;21;1;3;0;3
E:\workspace\java\hibernate-orm\hibernate-core\src\main\java\org\hibernate\hql\internal\ast\util\ASTUtil.java;ASTUtil.java;480;25;17;8;1;2;0;2
E:\workspace\java\hibernate-orm\hibernate-core\src\main\java\org\hibernate\internal\util\config\ConfigurationHelper.java;ConfigurationHelper.java;480;11;4;7;2;3;0;3
E:\workspace\java\hibernate-orm\hibernate-core\src\main\java\org\hibernate\boot\MetadataBuilder.java;MetadataBuilder.java;479;14;0;14;1;1;0;1
E:\workspace\java\hibernate-orm\tooling\metamodel-generator\src\main\java\org\hibernate\jpamodelgen\util\TypeUtils.java;TypeUtils.java;471;161;102;59;2;6;3;3
E:\workspace\java\hibernate-orm\hibernate-core\src\main\java\org\hibernate\boot\registry\selector\internal\StrategySelectorBuilder.java;StrategySelectorBuilder.java;471;37;18;19;2;4;0;4
E:\workspace\java\hibernate-orm\hibernate-core\src\main\java\org\hibernate\boot\internal\SessionFactoryBuilderImpl.java;SessionFactoryBuilderImpl.java;470;1497;118;1379;2;9;0;9
E:\workspace\java\hibernate-orm\hibernate-core\src\main\java\org\hibernate\resource\transaction\backend\jta\internal\JtaTransactionCoordinatorImpl.java;JtaTransactionCoordinatorImpl.java;468;46;29;17;3;5;0;5
E:\workspace\java\hibernate-orm\hibernate-core\src\main\java\org\hibernate\proxy\AbstractLazyInitializer.java;AbstractLazyInitializer.java;466;164;124;40;5;10;0;10
E:\workspace\java\hibernate-orm\hibernate-core\src\main\java\org\hibernate\collection\spi\PersistentCollection.java;PersistentCollection.java;463;115;67;48;3;4;0;4
E:\workspace\java\hibernate-orm\hibernate-core\src\main\java\org\hibernate\engine\jdbc\connections\internal\DriverManagerConnectionProviderImpl.java;DriverManagerConnectionProviderImpl.java;463;192;125;67;2;2;1;1
E:\workspace\java\hibernate-orm\hibernate-core\src\main\java\org\hibernate\service\internal\AbstractServiceRegistryImpl.java;AbstractServiceRegistryImpl.java;462;47;41;6;3;5;0;5
E:\workspace\java\hibernate-orm\hibernate-core\src\main\java\org\hibernate\SQLQuery.java;SQLQuery.java;456;42;21;21;1;2;1;1
E:\workspace\java\hibernate-orm\hibernate-core\src\main\java\org\hibernate\engine\query\spi\HQLQueryPlan.java;HQLQueryPlan.java;455;56;29;27;3;6;1;5
E:\workspace\java\hibernate-orm\hibernate-core\src\main\java\org\hibernate\boot\spi\AbstractDelegatingSessionFactoryOptions.java;AbstractDelegatingSessionFactoryOptions.java;455;73;57;16;4;13;0;13
E:\workspace\java\hibernate-orm\hibernate-core\src\main\java\org\hibernate\dialect\H2Dialect.java;H2Dialect.java;453;23;13;10;1;1;0;1
E:\workspace\java\hibernate-orm\hibernate-core\src\main\java\org\hibernate\engine\internal\ForeignKeys.java;ForeignKeys.java;451;126;97;29;4;5;1;4
E:\workspace\java\hibernate-orm\hibernate-core\src\main\java\org\hibernate\persister\entity\AbstractPropertyMapping.java;AbstractPropertyMapping.java;451;529;334;195;4;11;5;6
E:\workspace\java\hibernate-orm\hibernate-core\src\main\java\org\hibernate\internal\util\collections\ArrayHelper.java;ArrayHelper.java;450;20;19;1;2;3;1;2
E:\workspace\java\hibernate-orm\hibernate-core\src\main\java\org\hibernate\boot\spi\AbstractDelegatingSessionFactoryBuilder.java;AbstractDelegatingSessionFactoryBuilder.java;450;24;15;9;1;3;0;3
E:\workspace\java\hibernate-orm\hibernate-core\src\main\java\org\hibernate\bytecode\enhance\internal\javassist\EntityEnhancer.java;EntityEnhancer.java;448;12;5;7;1;1;0;1
E:\workspace\java\hibernate-orm\hibernate-core\src\main\java\org\hibernate\engine\query\spi\QueryPlanCache.java;QueryPlanCache.java;448;51;35;16;3;5;0;5
E:\workspace\java\hibernate-orm\hibernate-core\src\main\java\org\hibernate\query\criteria\internal\QueryStructure.java;QueryStructure.java;445;179;118;61;3;3;1;2
E:\workspace\java\hibernate-orm\hibernate-core\src\main\java\org\hibernate\boot\internal\MetadataImpl.java;MetadataImpl.java;445;103;84;19;3;7;0;7
E:\workspace\java\hibernate-orm\hibernate-core\src\main\java\org\hibernate\criterion\DetachedCriteria.java;DetachedCriteria.java;442;10;5;5;1;1;1;0
E:\workspace\java\hibernate-orm\hibernate-core\src\main\java\org\hibernate\hql\internal\ast\util\SessionFactoryHelper.java;SessionFactoryHelper.java;440;28;22;6;2;3;0;3
E:\workspace\java\hibernate-orm\hibernate-core\src\main\java\org\hibernate\dialect\SybaseASE15Dialect.java;SybaseASE15Dialect.java;439;5;5;0;1;1;0;1
E:\workspace\java\hibernate-orm\hibernate-core\src\main\java\org\hibernate\cache\spi\support\AbstractReadWriteAccess.java;AbstractReadWriteAccess.java;439;35;20;15;3;5;1;4
E:\workspace\java\hibernate-orm\hibernate-core\src\main\java\org\hibernate\engine\spi\CollectionEntry.java;CollectionEntry.java;437;60;31;29;1;2;1;1
E:\workspace\java\hibernate-orm\hibernate-core\src\main\java\org\hibernate\boot\model\source\internal\hbm\AbstractEntitySourceImpl.java;AbstractEntitySourceImpl.java;433;3;0;3;1;1;0;1
E:\workspace\java\hibernate-orm\hibernate-core\src\main\java\org\hibernate\engine\loading\internal\CollectionLoadContext.java;CollectionLoadContext.java;431;163;103;60;5;10;2;8
E:\workspace\java\hibernate-orm\hibernate-core\src\main\java\org\hibernate\hql\internal\ast\SqlGenerator.java;SqlGenerator.java;429;4;2;2;1;1;0;1
E:\workspace\java\hibernate-orm\hibernate-core\src\main\java\org\hibernate\persister\collection\BasicCollectionPersister.java;BasicCollectionPersister.java;428;197;122;75;3;3;0;3
E:\workspace\java\hibernate-orm\hibernate-core\src\main\java\org\hibernate\type\TypeFactory.java;TypeFactory.java;428;335;198;137;4;9;1;8
E:\workspace\java\hibernate-orm\hibernate-core\src\main\java\org\hibernate\engine\jdbc\env\internal\JdbcEnvironmentImpl.java;JdbcEnvironmentImpl.java;425;79;63;16;1;3;0;3
E:\workspace\java\hibernate-orm\hibernate-core\src\main\java\org\hibernate\bytecode\internal\javassist\BulkAccessorFactory.java;BulkAccessorFactory.java;423;2;1;1;1;1;0;1
E:\workspace\java\hibernate-orm\hibernate-core\src\main\java\org\hibernate\engine\spi\SessionFactoryImplementor.java;SessionFactoryImplementor.java;420;177;20;157;2;4;0;4
E:\workspace\java\hibernate-orm\hibernate-core\src\main\java\org\hibernate\hql\internal\ast\tree\IdentNode.java;IdentNode.java;416;14;3;11;2;2;0;2
E:\workspace\java\hibernate-orm\hibernate-core\src\main\java\org\hibernate\dialect\Oracle9Dialect.java;Oracle9Dialect.java;415;13;12;1;1;2;0;2
E:\workspace\java\hibernate-orm\hibernate-envers\src\main\java\org\hibernate\envers\internal\tools\query\QueryBuilder.java;QueryBuilder.java;413;98;89;9;1;1;1;0
E:\workspace\java\hibernate-orm\hibernate-core\src\main\java\org\hibernate\type\TypeHelper.java;TypeHelper.java;413;52;19;33;4;5;3;2
E:\workspace\java\hibernate-orm\hibernate-spatial\src\main\java\org\hibernate\spatial\dialect\hana\HANASpatialDialect.java;HANASpatialDialect.java;411;330;255;75;3;3;0;3
E:\workspace\java\hibernate-orm\hibernate-core\src\main\java\org\hibernate\type\AbstractStandardBasicType.java;AbstractStandardBasicType.java;408;72;36;36;2;4;1;3
E:\workspace\java\hibernate-orm\hibernate-core\src\main\java\org\hibernate\event\internal\DefaultDeleteEventListener.java;DefaultDeleteEventListener.java;407;52;42;10;5;5;0;5
E:\workspace\java\hibernate-orm\hibernate-core\src\main\java\org\hibernate\query\procedure\internal\ProcedureParameterImpl.java;ProcedureParameterImpl.java;402;68;37;31;2;3;1;2
E:\workspace\java\hibernate-orm\hibernate-core\src\main\java\org\hibernate\event\internal\AbstractFlushingEventListener.java;AbstractFlushingEventListener.java;402;236;123;113;3;5;0;5
E:\workspace\java\hibernate-orm\hibernate-core\src\main\java\org\hibernate\query\criteria\internal\CriteriaQueryImpl.java;CriteriaQueryImpl.java;401;37;25;12;2;2;0;2
E:\workspace\java\hibernate-orm\hibernate-core\src\main\java\org\hibernate\Cache.java;Cache.java;399;267;240;27;1;1;0;1
E:\workspace\java\hibernate-orm\hibernate-core\src\main\java\org\hibernate\pretty\MessageHelper.java;MessageHelper.java;398;2;1;1;1;1;0;1
E:\workspace\java\hibernate-orm\hibernate-core\src\main\java\org\hibernate\loader\plan\exec\internal\AliasResolutionContextImpl.java;AliasResolutionContextImpl.java;396;13;8;5;3;3;0;3
E:\workspace\java\hibernate-orm\hibernate-envers\src\main\java\org\hibernate\envers\query\criteria\AuditProperty.java;AuditProperty.java;395;12;11;1;1;1;1;0
E:\workspace\java\hibernate-orm\hibernate-core\src\main\java\org\hibernate\loader\entity\CacheEntityLoaderHelper.java;CacheEntityLoaderHelper.java;394;408;401;7;3;3;0;3
E:\workspace\java\hibernate-orm\hibernate-core\src\main\java\org\hibernate\engine\jdbc\internal\BasicFormatterImpl.java;BasicFormatterImpl.java;393;15;11;4;2;3;0;3
E:\workspace\java\hibernate-orm\hibernate-core\src\main\java\org\hibernate\context\internal\ThreadLocalSessionContext.java;ThreadLocalSessionContext.java;391;65;30;35;2;2;0;2
E:\workspace\java\hibernate-orm\hibernate-core\src\main\java\org\hibernate\mapping\Column.java;Column.java;390;38;24;14;3;4;0;4
E:\workspace\java\hibernate-orm\hibernate-core\src\main\java\org\hibernate\cfg\ClassPropertyHolder.java;ClassPropertyHolder.java;390;2;1;1;1;1;0;1
E:\workspace\java\hibernate-orm\hibernate-core\src\main\java\org\hibernate\stat\Statistics.java;Statistics.java;389;192;141;51;2;5;0;5
E:\workspace\java\hibernate-orm\hibernate-core\src\main\java\org\hibernate\boot\model\process\spi\MetadataBuildingProcess.java;MetadataBuildingProcess.java;387;120;66;54;3;6;0;6
E:\workspace\java\hibernate-orm\hibernate-core\src\main\java\org\hibernate\type\spi\TypeConfiguration.java;TypeConfiguration.java;385;539;462;77;5;15;1;14
E:\workspace\java\hibernate-orm\hibernate-core\src\main\java\org\hibernate\boot\model\source\internal\hbm\AbstractPluralAttributeSourceImpl.java;AbstractPluralAttributeSourceImpl.java;385;69;49;20;1;3;0;3
E:\workspace\java\hibernate-orm\hibernate-core\src\main\java\org\hibernate\event\internal\MergeContext.java;MergeContext.java;383;17;3;14;3;3;1;2
E:\workspace\java\hibernate-orm\hibernate-core\src\main\java\org\hibernate\jpa\AvailableSettings.java;AvailableSettings.java;380;27;24;3;2;2;1;1
E:\workspace\java\hibernate-orm\hibernate-core\src\main\java\org\hibernate\engine\spi\BatchFetchQueue.java;BatchFetchQueue.java;375;88;58;30;3;4;1;3
E:\workspace\java\hibernate-orm\hibernate-core\src\main\java\org\hibernate\resource\jdbc\internal\ResourceRegistryStandardImpl.java;ResourceRegistryStandardImpl.java;373;156;84;72;3;6;0;6
E:\workspace\java\hibernate-orm\hibernate-core\src\main\java\org\hibernate\event\internal\DefaultSaveOrUpdateEventListener.java;DefaultSaveOrUpdateEventListener.java;371;39;21;18;2;2;0;2
E:\workspace\java\hibernate-orm\hibernate-core\src\main\java\org\hibernate\hql\internal\ast\util\JoinProcessor.java;JoinProcessor.java;370;91;89;2;1;2;0;2
E:\workspace\java\hibernate-orm\hibernate-core\src\main\java\org\hibernate\mapping\Property.java;Property.java;368;43;23;20;1;1;0;1
E:\workspace\java\hibernate-orm\hibernate-core\src\main\java\org\hibernate\bytecode\internal\bytebuddy\ByteBuddyState.java;ByteBuddyState.java;366;662;514;148;2;14;0;14
E:\workspace\java\hibernate-orm\hibernate-core\src\main\java\org\hibernate\loader\plan\exec\process\internal\ResultSetProcessingContextImpl.java;ResultSetProcessingContextImpl.java;365;6;4;2;1;1;0;1
E:\workspace\java\hibernate-orm\hibernate-core\src\main\java\org\hibernate\action\internal\EntityUpdateAction.java;EntityUpdateAction.java;365;53;33;20;2;4;0;4
E:\workspace\java\hibernate-orm\hibernate-core\src\main\java\org\hibernate\mapping\RootClass.java;RootClass.java;364;3;2;1;1;1;0;1
E:\workspace\java\hibernate-orm\hibernate-core\src\main\java\org\hibernate\ScrollableResults.java;ScrollableResults.java;361;3;2;1;1;1;1;0
E:\workspace\java\hibernate-orm\hibernate-core\src\main\java\org\hibernate\dialect\CUBRIDDialect.java;CUBRIDDialect.java;361;9;8;1;1;1;0;1
E:\workspace\java\hibernate-orm\hibernate-core\src\main\java\org\hibernate\cfg\Environment.java;Environment.java;360;60;38;22;2;6;0;6
E:\workspace\java\hibernate-orm\hibernate-core\src\main\java\org\hibernate\boot\spi\InFlightMetadataCollector.java;InFlightMetadataCollector.java;360;24;15;9;1;4;0;4
E:\workspace\java\hibernate-orm\hibernate-core\src\main\java\org\hibernate\type\ManyToOneType.java;ManyToOneType.java;358;105;62;43;3;5;1;4
E:\workspace\java\hibernate-orm\hibernate-core\src\main\java\org\hibernate\cfg\annotations\reflection\XMLContext.java;XMLContext.java;358;37;23;14;1;2;0;2
E:\workspace\java\hibernate-orm\hibernate-core\src\main\java\org\hibernate\loader\custom\sql\SQLQueryParser.java;SQLQueryParser.java;356;5;4;1;1;1;0;1
E:\workspace\java\hibernate-orm\hibernate-ehcache\src\main\java\org\hibernate\cache\ehcache\internal\EhcacheRegionFactory.java;EhcacheRegionFactory.java;356;658;507;151;3;12;0;12
E:\workspace\java\hibernate-orm\hibernate-core\src\main\java\org\hibernate\bytecode\enhance\internal\bytebuddy\BiDirectionalAssociationHandler.java;BiDirectionalAssociationHandler.java;355;85;55;30;1;3;0;3
E:\workspace\java\hibernate-orm\hibernate-envers\src\main\java\org\hibernate\envers\query\internal\impl\AbstractAuditQuery.java;AbstractAuditQuery.java;354;18;16;2;1;3;1;2
E:\workspace\java\hibernate-orm\hibernate-envers\src\main\java\org\hibernate\envers\query\AuditQueryCreator.java;AuditQueryCreator.java;353;133;130;3;1;2;0;2
E:\workspace\java\hibernate-orm\hibernate-spatial\src\main\java\org\hibernate\spatial\dialect\oracle\OracleSpatialFunctions.java;OracleSpatialFunctions.java;350;61;30;31;1;1;0;1
E:\workspace\java\hibernate-orm\hibernate-core\src\main\java\org\hibernate\type\CustomType.java;CustomType.java;350;78;44;34;1;1;0;1
E:\workspace\java\hibernate-orm\hibernate-envers\src\main\java\org\hibernate\envers\internal\entities\mapper\relation\AbstractCollectionMapper.java;AbstractCollectionMapper.java;349;382;157;225;2;5;1;4
E:\workspace\java\hibernate-orm\hibernate-spatial\src\main\java\org\hibernate\spatial\dialect\db2\DB2SpatialDialect.java;DB2SpatialDialect.java;346;350;348;2;2;4;0;4
E:\workspace\java\hibernate-orm\hibernate-core\src\main\java\org\hibernate\query\criteria\internal\ValueHandlerFactory.java;ValueHandlerFactory.java;346;9;9;0;1;1;1;0
E:\workspace\java\hibernate-orm\hibernate-core\src\main\java\org\hibernate\boot\internal\BootstrapContextImpl.java;BootstrapContextImpl.java;344;356;350;6;1;6;0;6
E:\workspace\java\hibernate-orm\hibernate-core\src\main\java\org\hibernate\bytecode\enhance\internal\bytebuddy\PersistentAttributeTransformer.java;PersistentAttributeTransformer.java;343;109;68;41;3;8;0;8
E:\workspace\java\hibernate-orm\hibernate-core\src\main\java\org\hibernate\boot\registry\StandardServiceRegistryBuilder.java;StandardServiceRegistryBuilder.java;341;44;25;19;3;6;0;6
E:\workspace\java\hibernate-orm\hibernate-core\src\main\java\org\hibernate\boot\model\source\internal\annotations\AnnotationMetadataSourceProcessorImpl.java;AnnotationMetadataSourceProcessorImpl.java;340;50;27;23;2;2;0;2
E:\workspace\java\hibernate-orm\hibernate-core\src\main\java\org\hibernate\jpa\event\internal\CallbackBuilderLegacyImpl.java;CallbackBuilderLegacyImpl.java;338;209;152;57;4;8;0;8
E:\workspace\java\hibernate-orm\hibernate-core\src\main\java\org\hibernate\tuple\PropertyFactory.java;PropertyFactory.java;338;30;19;11;3;3;0;3
E:\workspace\java\hibernate-orm\hibernate-envers\src\main\java\org\hibernate\envers\configuration\internal\metadata\IdMetadataGenerator.java;IdMetadataGenerator.java;338;188;139;49;1;2;2;0
E:\workspace\java\hibernate-orm\hibernate-core\src\main\java\org\hibernate\engine\jdbc\spi\SqlExceptionHelper.java;SqlExceptionHelper.java;337;17;15;2;1;1;0;1
E:\workspace\java\hibernate-orm\hibernate-core\src\main\java\org\hibernate\metamodel\model\domain\internal\AbstractIdentifiableType.java;AbstractIdentifiableType.java;336;424;380;44;1;2;0;2
E:\workspace\java\hibernate-orm\hibernate-core\src\main\java\org\hibernate\cfg\InheritanceState.java;InheritanceState.java;335;4;2;2;1;1;0;1
E:\workspace\java\hibernate-orm\hibernate-spatial\src\main\java\org\hibernate\spatial\dialect\oracle\OracleSDOSupport.java;OracleSDOSupport.java;334;23;14;9;3;3;1;2
E:\workspace\java\hibernate-orm\hibernate-core\src\main\java\org\hibernate\resource\transaction\backend\jdbc\internal\JdbcResourceLocalTransactionCoordinatorImpl.java;JdbcResourceLocalTransactionCoordinatorImpl.java;334;42;32;10;4;5;0;5
E:\workspace\java\hibernate-orm\hibernate-core\src\main\java\org\hibernate\tool\hbm2ddl\SchemaExportTask.java;SchemaExportTask.java;333;2;2;0;1;1;0;1
E:\workspace\java\hibernate-orm\hibernate-core\src\main\java\org\hibernate\engine\spi\CascadeStyles.java;CascadeStyles.java;332;3;2;1;1;1;0;1
E:\workspace\java\hibernate-orm\hibernate-core\src\main\java\org\hibernate\engine\jdbc\env\internal\ExtractedDatabaseMetaDataImpl.java;ExtractedDatabaseMetaDataImpl.java;330;32;22;10;2;3;0;3
E:\workspace\java\hibernate-orm\hibernate-core\src\main\java\org\hibernate\type\EnumType.java;EnumType.java;329;32;25;7;2;2;0;2
E:\workspace\java\hibernate-orm\hibernate-core\src\main\java\org\hibernate\persister\walking\spi\MetamodelGraphWalker.java;MetamodelGraphWalker.java;329;199;116;83;2;2;1;1
E:\workspace\java\hibernate-orm\hibernate-core\src\main\java\org\hibernate\graph\internal\AttributeNodeImpl.java;AttributeNodeImpl.java;327;371;349;22;1;2;0;2
E:\workspace\java\hibernate-orm\hibernate-core\src\main\java\org\hibernate\cfg\ExternalSessionFactoryConfig.java;ExternalSessionFactoryConfig.java;324;8;4;4;1;2;1;1
E:\workspace\java\hibernate-orm\hibernate-core\src\main\java\org\hibernate\persister\collection\CollectionPersister.java;CollectionPersister.java;323;10;7;3;1;1;0;1
E:\workspace\java\hibernate-orm\hibernate-core\src\main\java\org\hibernate\dialect\IngresDialect.java;IngresDialect.java;323;7;7;0;1;1;0;1
E:\workspace\java\hibernate-orm\hibernate-core\src\main\java\org\hibernate\loader\plan\exec\process\internal\AbstractRowReader.java;AbstractRowReader.java;323;52;47;5;2;3;0;3
E:\workspace\java\hibernate-orm\hibernate-core\src\main\java\org\hibernate\cfg\Settings.java;Settings.java;323;42;23;19;3;8;1;7
E:\workspace\java\hibernate-orm\hibernate-core\src\main\java\org\hibernate\tuple\entity\PojoEntityTuplizer.java;PojoEntityTuplizer.java;320;119;58;61;3;4;0;4
E:\workspace\java\hibernate-orm\hibernate-core\src\main\java\org\hibernate\tool\schema\internal\HibernateSchemaManagementTool.java;HibernateSchemaManagementTool.java;320;5;1;4;1;1;0;1
E:\workspace\java\hibernate-orm\hibernate-core\src\main\java\org\hibernate\boot\spi\SessionFactoryOptions.java;SessionFactoryOptions.java;319;93;77;16;5;16;1;15
E:\workspace\java\hibernate-orm\tooling\metamodel-generator\src\main\java\org\hibernate\jpamodelgen\annotation\MetaAttributeGenerationVisitor.java;MetaAttributeGenerationVisitor.java;317;28;13;15;2;3;1;2
E:\workspace\java\hibernate-orm\hibernate-core\src\main\java\org\hibernate\dialect\InformixDialect.java;InformixDialect.java;315;16;11;5;2;2;0;2
E:\workspace\java\hibernate-orm\hibernate-core\src\main\java\org\hibernate\hql\internal\ast\tree\MapEntryNode.java;MapEntryNode.java;313;22;13;9;1;2;0;2
E:\workspace\java\hibernate-orm\hibernate-core\src\main\java\org\hibernate\internal\AbstractScrollableResults.java;AbstractScrollableResults.java;312;8;5;3;1;1;0;1
E:\workspace\java\hibernate-orm\hibernate-core\src\main\java\org\hibernate\collection\internal\PersistentArrayHolder.java;PersistentArrayHolder.java;312;29;28;1;1;1;0;1
E:\workspace\java\hibernate-orm\hibernate-core\src\main\java\org\hibernate\action\internal\UnresolvedEntityInsertActions.java;UnresolvedEntityInsertActions.java;311;2;1;1;1;1;0;1
E:\workspace\java\hibernate-orm\hibernate-envers\src\main\java\org\hibernate\envers\event\spi\BaseEnversCollectionEventListener.java;BaseEnversCollectionEventListener.java;309;16;13;3;2;2;1;1
E:\workspace\java\hibernate-orm\hibernate-core\src\main\java\org\hibernate\tool\hbm2ddl\SchemaUpdate.java;SchemaUpdate.java;309;4;1;3;2;2;0;2
E:\workspace\java\hibernate-orm\hibernate-core\src\main\java\org\hibernate\query\internal\ParameterMetadataImpl.java;ParameterMetadataImpl.java;309;50;31;19;2;5;0;5
E:\workspace\java\hibernate-orm\hibernate-core\src\main\java\org\hibernate\boot\registry\internal\BootstrapServiceRegistryImpl.java;BootstrapServiceRegistryImpl.java;309;12;6;6;2;2;0;2
E:\workspace\java\hibernate-orm\hibernate-core\src\main\java\org\hibernate\cfg\OneToOneSecondPass.java;OneToOneSecondPass.java;309;76;33;43;4;4;0;4
E:\workspace\java\hibernate-orm\tooling\hibernate-enhance-maven-plugin\src\main\java\org\hibernate\orm\tooling\maven\MavenEnhancePlugin.java;MavenEnhancePlugin.java;308;33;20;13;1;3;0;3
E:\workspace\java\hibernate-orm\hibernate-core\src\main\java\org\hibernate\graph\EntityGraphs.java;EntityGraphs.java;306;648;477;171;1;2;0;2
E:\workspace\java\hibernate-orm\hibernate-core\src\main\java\org\hibernate\internal\ExceptionConverterImpl.java;ExceptionConverterImpl.java;305;156;90;66;2;2;0;2
E:\workspace\java\hibernate-orm\hibernate-core\src\main\java\org\hibernate\loader\plan\exec\process\internal\ResultSetProcessorImpl.java;ResultSetProcessorImpl.java;305;40;25;15;1;3;0;3
E:\workspace\java\hibernate-orm\hibernate-core\src\main\java\org\hibernate\loader\plan\exec\internal\AbstractLoadQueryDetails.java;AbstractLoadQueryDetails.java;302;65;37;28;2;3;0;3
E:\workspace\java\hibernate-orm\hibernate-core\src\main\java\org\hibernate\engine\internal\Collections.java;Collections.java;302;126;69;57;3;4;0;4
E:\workspace\java\hibernate-orm\hibernate-core\src\main\java\org\hibernate\boot\registry\classloading\internal\ClassLoaderServiceImpl.java;ClassLoaderServiceImpl.java;299;523;162;361;3;8;0;8
E:\workspace\java\hibernate-orm\hibernate-envers\src\main\java\org\hibernate\envers\AuditReader.java;AuditReader.java;299;20;16;4;1;1;0;1
E:\workspace\java\hibernate-orm\hibernate-core\src\main\java\org\hibernate\persister\walking\internal\CompositionSingularSubAttributesHelper.java;CompositionSingularSubAttributesHelper.java;298;17;15;2;1;1;0;1
E:\workspace\java\hibernate-orm\hibernate-jcache\src\main\java\org\hibernate\cache\jcache\internal\JCacheRegionFactory.java;JCacheRegionFactory.java;297;749;523;226;4;11;0;11
E:\workspace\java\hibernate-orm\hibernate-envers\src\main\java\org\hibernate\envers\boot\internal\EnversServiceImpl.java;EnversServiceImpl.java;295;33;12;21;3;5;0;5
E:\workspace\java\hibernate-orm\hibernate-core\src\main\java\org\hibernate\cache\internal\QueryResultsCacheImpl.java;QueryResultsCacheImpl.java;294;23;10;13;1;1;0;1
E:\workspace\java\hibernate-orm\hibernate-core\src\main\java\org\hibernate\engine\loading\internal\LoadContexts.java;LoadContexts.java;292;10;5;5;1;1;0;1
E:\workspace\java\hibernate-orm\hibernate-core\src\main\java\org\hibernate\bytecode\internal\bytebuddy\BytecodeProviderImpl.java;BytecodeProviderImpl.java;291;198;106;92;3;11;0;11
E:\workspace\java\hibernate-orm\hibernate-spatial\src\main\java\org\hibernate\spatial\criterion\SpatialRestrictions.java;SpatialRestrictions.java;288;12;6;6;1;2;0;2
E:\workspace\java\hibernate-orm\hibernate-core\src\main\java\org\hibernate\loader\plan\build\spi\QuerySpaceTreePrinter.java;QuerySpaceTreePrinter.java;287;11;5;6;2;2;0;2
E:\workspace\java\hibernate-orm\hibernate-core\src\main\java\org\hibernate\engine\internal\SessionEventListenerManagerImpl.java;SessionEventListenerManagerImpl.java;286;118;66;52;1;1;0;1
E:\workspace\java\hibernate-orm\hibernate-core\src\main\java\org\hibernate\engine\spi\LoadQueryInfluencers.java;LoadQueryInfluencers.java;285;145;115;30;2;2;0;2
E:\workspace\java\hibernate-orm\hibernate-core\src\main\java\org\hibernate\boot\registry\classloading\internal\AggregatedServiceLoader.java;AggregatedServiceLoader.java;285;507;396;111;1;5;0;5
E:\workspace\java\hibernate-orm\hibernate-core\src\main\java\org\hibernate\engine\jdbc\env\spi\AnsiSqlKeywords.java;AnsiSqlKeywords.java;285;2;0;2;1;1;0;1
E:\workspace\java\hibernate-orm\hibernate-core\src\main\java\org\hibernate\cfg\AttributeConverterDefinition.java;AttributeConverterDefinition.java;283;18;6;12;2;2;0;2
E:\workspace\java\hibernate-orm\hibernate-core\src\main\java\org\hibernate\bytecode\enhance\spi\interceptor\EnhancementAsProxyLazinessInterceptor.java;EnhancementAsProxyLazinessInterceptor.java;283;305;294;11;2;3;0;3
E:\workspace\java\hibernate-orm\hibernate-core\src\main\java\org\hibernate\cache\spi\QueryKey.java;QueryKey.java;282;12;6;6;1;1;0;1
E:\workspace\java\hibernate-orm\hibernate-core\src\main\java\org\hibernate\tuple\entity\EntityTuplizer.java;EntityTuplizer.java;281;5;5;0;1;1;0;1
E:\workspace\java\hibernate-orm\hibernate-envers\src\main\java\org\hibernate\envers\internal\entities\mapper\MultiPropertyMapper.java;MultiPropertyMapper.java;281;2;1;1;1;1;0;1
E:\workspace\java\hibernate-orm\hibernate-core\src\main\java\org\hibernate\internal\FastSessionServices.java;FastSessionServices.java;280;520;400;120;1;14;0;14
E:\workspace\java\hibernate-orm\hibernate-core\src\main\java\org\hibernate\boot\spi\AbstractDelegatingMetadataBuilderImplementor.java;AbstractDelegatingMetadataBuilderImplementor.java;279;6;0;6;1;1;0;1
E:\workspace\java\hibernate-orm\hibernate-core\src\main\java\org\hibernate\boot\model\process\internal\ScanningCoordinator.java;ScanningCoordinator.java;279;29;15;14;1;1;0;1
E:\workspace\java\hibernate-orm\hibernate-core\src\main\java\org\hibernate\bytecode\enhance\internal\javassist\AttributeTypeDescriptor.java;AttributeTypeDescriptor.java;279;12;6;6;2;2;1;1
E:\workspace\java\hibernate-orm\hibernate-core\src\main\java\org\hibernate\boot\spi\MetadataBuildingOptions.java;MetadataBuildingOptions.java;279;258;152;106;3;6;0;6
E:\workspace\java\hibernate-orm\hibernate-core\src\main\java\org\hibernate\loader\plan\build\internal\AbstractEntityGraphVisitationStrategy.java;AbstractEntityGraphVisitationStrategy.java;278;209;73;136;2;2;1;1
E:\workspace\java\hibernate-orm\hibernate-envers\src\main\java\org\hibernate\envers\configuration\internal\metadata\reader\PropertyAuditingData.java;PropertyAuditingData.java;278;14;14;0;1;1;1;0
E:\workspace\java\hibernate-orm\hibernate-core\src\main\java\org\hibernate\dialect\TimesTenDialect.java;TimesTenDialect.java;277;9;8;1;1;1;0;1
E:\workspace\java\hibernate-orm\hibernate-core\src\main\java\org\hibernate\loader\entity\plan\AbstractLoadPlanBasedEntityLoader.java;AbstractLoadPlanBasedEntityLoader.java;276;75;63;12;3;4;0;4
E:\workspace\java\hibernate-orm\hibernate-spatial\src\main\java\org\hibernate\spatial\dialect\oracle\criterion\SDOParameterMap.java;SDOParameterMap.java;276;2;1;1;1;1;0;1
E:\workspace\java\hibernate-orm\hibernate-core\src\main\java\org\hibernate\boot\model\source\internal\hbm\SingularAttributeSourceAnyImpl.java;SingularAttributeSourceAnyImpl.java;276;5;5;0;1;1;0;1
E:\workspace\java\hibernate-orm\hibernate-core\src\main\java\org\hibernate\boot\model\source\internal\hbm\Helper.java;Helper.java;275;22;4;18;1;2;0;2
E:\workspace\java\hibernate-orm\hibernate-core\src\main\java\org\hibernate\query\criteria\internal\CriteriaSubqueryImpl.java;CriteriaSubqueryImpl.java;274;23;11;12;3;3;0;3
E:\workspace\java\hibernate-orm\hibernate-core\src\main\java\org\hibernate\hql\internal\ast\tree\BinaryLogicOperatorNode.java;BinaryLogicOperatorNode.java;274;2;1;1;1;1;0;1
E:\workspace\java\hibernate-orm\hibernate-core\src\main\java\org\hibernate\resource\jdbc\internal\LogicalConnectionManagedImpl.java;LogicalConnectionManagedImpl.java;274;24;10;14;2;3;0;3
E:\workspace\java\hibernate-orm\hibernate-core\src\main\java\org\hibernate\resource\beans\container\internal\JpaCompliantLifecycleStrategy.java;JpaCompliantLifecycleStrategy.java;273;329;301;28;2;4;0;4
E:\workspace\java\hibernate-orm\hibernate-core\src\main\java\org\hibernate\dialect\Teradata14Dialect.java;Teradata14Dialect.java;270;5;3;2;1;2;0;2
E:\workspace\java\hibernate-orm\hibernate-core\src\main\java\org\hibernate\tuple\entity\BytecodeEnhancementMetadataPojoImpl.java;BytecodeEnhancementMetadataPojoImpl.java;270;194;168;26;3;5;0;5
E:\workspace\java\hibernate-orm\hibernate-core\src\main\java\org\hibernate\event\internal\DefaultRefreshEventListener.java;DefaultRefreshEventListener.java;270;127;85;42;5;7;1;6
E:\workspace\java\hibernate-orm\hibernate-core\src\main\java\org\hibernate\stat\spi\StatisticsImplementor.java;StatisticsImplementor.java;269;110;72;38;2;3;0;3
E:\workspace\java\hibernate-orm\hibernate-core\src\main\java\org\hibernate\action\internal\BulkOperationCleanupAction.java;BulkOperationCleanupAction.java;269;84;51;33;2;6;1;5
E:\workspace\java\hibernate-orm\hibernate-core\src\main\java\org\hibernate\metadata\ClassMetadata.java;ClassMetadata.java;269;62;60;2;1;1;1;0
E:\workspace\java\hibernate-orm\hibernate-core\src\main\java\org\hibernate\event\service\internal\EventListenerGroupImpl.java;EventListenerGroupImpl.java;268;167;137;30;3;5;0;5
E:\workspace\java\hibernate-orm\hibernate-core\src\main\java\org\hibernate\boot\model\naming\ImplicitNamingStrategyJpaCompliantImpl.java;ImplicitNamingStrategyJpaCompliantImpl.java;268;7;4;3;1;1;0;1
E:\workspace\java\hibernate-orm\hibernate-core\src\main\java\org\hibernate\action\internal\EntityInsertAction.java;EntityInsertAction.java;266;45;27;18;2;4;0;4
E:\workspace\java\hibernate-orm\hibernate-core\src\main\java\org\hibernate\engine\spi\CacheImplementor.java;CacheImplementor.java;266;424;281;143;1;3;0;3
E:\workspace\java\hibernate-orm\hibernate-core\src\main\java\org\hibernate\hql\internal\ast\tree\IntoClause.java;IntoClause.java;265;14;7;7;1;2;1;1
E:\workspace\java\hibernate-orm\hibernate-envers\src\main\java\org\hibernate\envers\internal\entities\mapper\relation\query\ThreeEntityQueryGenerator.java;ThreeEntityQueryGenerator.java;265;119;57;62;1;1;1;0
E:\workspace\java\hibernate-orm\hibernate-core\src\main\java\org\hibernate\collection\internal\PersistentSortedMap.java;PersistentSortedMap.java;262;23;23;0;1;1;0;1
E:\workspace\java\hibernate-orm\hibernate-core\src\main\java\org\hibernate\loader\plan\exec\internal\EntityLoadQueryDetails.java;EntityLoadQueryDetails.java;262;81;47;34;3;5;0;5
E:\workspace\java\hibernate-orm\hibernate-spatial\src\main\java\org\hibernate\spatial\dialect\oracle\criterion\OracleSpatialRestrictions.java;OracleSpatialRestrictions.java;260;32;23;9;1;2;0;2
E:\workspace\java\hibernate-orm\hibernate-core\src\main\java\org\hibernate\cache\spi\CacheImplementor.java;CacheImplementor.java;260;292;276;16;2;4;0;4
E:\workspace\java\hibernate-orm\hibernate-core\src\main\java\org\hibernate\loader\collection\DynamicBatchingCollectionInitializerBuilder.java;DynamicBatchingCollectionInitializerBuilder.java;257;4;2;2;1;1;0;1
E:\workspace\java\hibernate-orm\tooling\metamodel-generator\src\main\java\org\hibernate\jpamodelgen\Context.java;Context.java;256;15;15;0;1;1;0;1
E:\workspace\java\hibernate-orm\hibernate-c3p0\src\main\java\org\hibernate\c3p0\internal\C3P0ConnectionProvider.java;C3P0ConnectionProvider.java;256;3;1;2;2;2;0;2
E:\workspace\java\hibernate-orm\hibernate-core\src\main\java\org\hibernate\engine\query\spi\ParameterParser.java;ParameterParser.java;255;6;3;3;2;3;1;2
E:\workspace\java\hibernate-orm\hibernate-core\src\main\java\org\hibernate\stat\internal\DeprecatedNaturalIdCacheStatisticsImpl.java;DeprecatedNaturalIdCacheStatisticsImpl.java;255;269;262;7;2;3;0;3
E:\workspace\java\hibernate-orm\hibernate-core\src\main\java\org\hibernate\internal\log\DeprecationLogger.java;DeprecationLogger.java;252;6;4;2;1;2;0;2
E:\workspace\java\hibernate-orm\hibernate-core\src\main\java\org\hibernate\action\internal\EntityIdentityInsertAction.java;EntityIdentityInsertAction.java;250;20;13;7;2;2;0;2
E:\workspace\java\hibernate-orm\hibernate-core\src\main\java\org\hibernate\query\criteria\internal\path\AbstractPathImpl.java;AbstractPathImpl.java;250;33;14;19;2;3;0;3
E:\workspace\java\hibernate-orm\hibernate-core\src\main\java\org\hibernate\boot\registry\BootstrapServiceRegistryBuilder.java;BootstrapServiceRegistryBuilder.java;249;2;1;1;1;1;1;0
E:\workspace\java\hibernate-orm\hibernate-core\src\main\java\org\hibernate\cache\spi\support\DomainDataRegionTemplate.java;DomainDataRegionTemplate.java;249;255;252;3;1;2;0;2
E:\workspace\java\hibernate-orm\hibernate-core\src\main\java\org\hibernate\engine\spi\NamedSQLQueryDefinition.java;NamedSQLQueryDefinition.java;247;6;3;3;1;2;1;1
E:\workspace\java\hibernate-orm\hibernate-core\src\main\java\org\hibernate\mapping\ForeignKey.java;ForeignKey.java;247;2;1;1;1;1;0;1
E:\workspace\java\hibernate-orm\hibernate-core\src\main\java\org\hibernate\boot\model\source\internal\hbm\MappingDocument.java;MappingDocument.java;246;18;12;6;1;2;0;2
E:\workspace\java\hibernate-orm\hibernate-core\src\main\java\org\hibernate\internal\util\collections\IdentityMap.java;IdentityMap.java;246;95;45;50;2;2;0;2
E:\workspace\java\hibernate-orm\hibernate-core\src\main\java\org\hibernate\dialect\SAPDBDialect.java;SAPDBDialect.java;245;20;16;4;2;3;0;3
E:\workspace\java\hibernate-orm\hibernate-core\src\main\java\org\hibernate\engine\transaction\internal\TransactionImpl.java;TransactionImpl.java;245;93;64;29;3;5;0;5
E:\workspace\java\hibernate-orm\hibernate-core\src\main\java\org\hibernate\Hibernate.java;Hibernate.java;245;32;31;1;2;2;0;2
E:\workspace\java\hibernate-orm\hibernate-core\src\main\java\org\hibernate\hql\internal\ast\tree\ConstructorNode.java;ConstructorNode.java;244;2;1;1;1;1;0;1
E:\workspace\java\hibernate-orm\hibernate-core\src\main\java\org\hibernate\mapping\Index.java;Index.java;243;2;1;1;1;1;0;1
E:\workspace\java\hibernate-orm\hibernate-core\src\main\java\org\hibernate\boot\spi\AbstractDelegatingMetadata.java;AbstractDelegatingMetadata.java;243;16;15;1;1;3;0;3
E:\workspace\java\hibernate-orm\hibernate-spatial\src\main\java\org\hibernate\spatial\dialect\postgis\PostgisNoSQLMM.java;PostgisNoSQLMM.java;242;140;70;70;1;1;0;1
E:\workspace\java\hibernate-orm\hibernate-jipijapa\src\main\java\org\jboss\as\jpa\hibernate5\management\HibernateQueryCacheStatistics.java;HibernateQueryCacheStatistics.java;242;606;424;182;1;2;0;2
E:\workspace\java\hibernate-orm\hibernate-core\src\main\java\org\hibernate\boot\model\relational\Namespace.java;Namespace.java;241;32;18;14;2;2;0;2
E:\workspace\java\hibernate-orm\hibernate-core\src\main\java\org\hibernate\internal\SessionFactoryRegistry.java;SessionFactoryRegistry.java;241;5;2;3;1;2;0;2
E:\workspace\java\hibernate-orm\hibernate-core\src\main\java\org\hibernate\engine\transaction\jta\platform\internal\WebSphereExtendedJtaPlatform.java;WebSphereExtendedJtaPlatform.java;239;4;2;2;1;1;0;1
E:\workspace\java\hibernate-orm\hibernate-core\src\main\java\org\hibernate\BasicQueryContract.java;BasicQueryContract.java;238;20;10;10;1;2;1;1
E:\workspace\java\hibernate-orm\hibernate-core\src\main\java\org\hibernate\cache\spi\support\AbstractDomainDataRegion.java;AbstractDomainDataRegion.java;237;84;57;27;2;3;0;3
E:\workspace\java\hibernate-orm\hibernate-envers\src\main\java\org\hibernate\envers\configuration\internal\GlobalConfiguration.java;GlobalConfiguration.java;235;11;11;0;1;1;1;0
E:\workspace\java\hibernate-orm\hibernate-core\src\main\java\org\hibernate\engine\jdbc\internal\ResultSetReturnImpl.java;ResultSetReturnImpl.java;234;44;36;8;1;2;0;2
E:\workspace\java\hibernate-orm\hibernate-core\src\main\java\org\hibernate\hql\internal\ast\tree\MethodNode.java;MethodNode.java;233;1;0;1;1;1;0;1
E:\workspace\java\hibernate-orm\hibernate-osgi\src\main\java\org\hibernate\osgi\OsgiClassLoader.java;OsgiClassLoader.java;233;164;93;71;1;1;0;1
E:\workspace\java\hibernate-orm\hibernate-core\src\main\java\org\hibernate\boot\registry\classloading\internal\AggregatedClassLoader.java;AggregatedClassLoader.java;231;233;232;1;2;2;0;2
E:\workspace\java\hibernate-orm\hibernate-core\src\main\java\org\hibernate\cache\internal\DisabledCaching.java;DisabledCaching.java;230;244;237;7;1;3;0;3
E:\workspace\java\hibernate-orm\hibernate-envers\src\main\java\org\hibernate\envers\query\internal\impl\RevisionsOfEntityQuery.java;RevisionsOfEntityQuery.java;227;138;99;39;1;2;0;2
E:\workspace\java\hibernate-orm\hibernate-core\src\main\java\org\hibernate\event\internal\DefaultReplicateEventListener.java;DefaultReplicateEventListener.java;227;22;12;10;2;2;0;2
E:\workspace\java\hibernate-orm\hibernate-jipijapa\src\main\java\org\jboss\as\jpa\hibernate5\HibernatePersistenceProviderAdaptor.java;HibernatePersistenceProviderAdaptor.java;227;609;418;191;2;6;0;6
E:\workspace\java\hibernate-orm\hibernate-core\src\main\java\org\hibernate\engine\internal\Nullability.java;Nullability.java;226;11;7;4;1;1;0;1
E:\workspace\java\hibernate-orm\hibernate-core\src\main\java\org\hibernate\boot\registry\selector\internal\StrategySelectorImpl.java;StrategySelectorImpl.java;225;56;37;19;3;4;0;4
E:\workspace\java\hibernate-orm\hibernate-core\src\main\java\org\hibernate\bytecode\internal\bytebuddy\HibernateMethodLookupDispatcher.java;HibernateMethodLookupDispatcher.java;225;429;327;102;1;4;0;4
E:\workspace\java\hibernate-orm\hibernate-core\src\main\java\org\hibernate\proxy\pojo\javassist\JavassistProxyFactory.java;JavassistProxyFactory.java;224;12;9;3;1;1;0;1
E:\workspace\java\hibernate-orm\hibernate-core\src\main\java\org\hibernate\tuple\component\AbstractCompositionAttribute.java;AbstractCompositionAttribute.java;224;20;10;10;2;2;0;2
E:\workspace\java\hibernate-orm\hibernate-envers\src\main\java\org\hibernate\envers\internal\entities\mapper\relation\BasicCollectionMapper.java;BasicCollectionMapper.java;223;144;142;2;1;3;1;2
E:\workspace\java\hibernate-orm\hibernate-core\src\main\java\org\hibernate\graph\GraphParser.java;GraphParser.java;222;222;222;0;1;1;0;1
E:\workspace\java\hibernate-orm\hibernate-core\src\main\java\org\hibernate\engine\jdbc\internal\StatementPreparerImpl.java;StatementPreparerImpl.java;222;26;11;15;2;3;0;3
E:\workspace\java\hibernate-orm\tooling\metamodel-generator\src\main\java\org\hibernate\jpamodelgen\ClassWriter.java;ClassWriter.java;222;5;2;3;2;2;0;2
E:\workspace\java\hibernate-orm\hibernate-core\src\main\java\org\hibernate\engine\jdbc\BlobProxy.java;BlobProxy.java;221;192;96;96;1;1;0;1
E:\workspace\java\hibernate-orm\hibernate-core\src\main\java\org\hibernate\internal\ScrollableResultsImpl.java;ScrollableResultsImpl.java;220;40;24;16;2;2;0;2
E:\workspace\java\hibernate-orm\hibernate-core\src\main\java\org\hibernate\engine\jdbc\ResultSetWrapperProxy.java;ResultSetWrapperProxy.java;220;117;91;26;1;1;0;1
E:\workspace\java\hibernate-orm\hibernate-core\src\main\java\org\hibernate\stat\internal\QueryStatisticsImpl.java;QueryStatisticsImpl.java;220;106;67;39;3;3;0;3
E:\workspace\java\hibernate-orm\hibernate-core\src\main\java\org\hibernate\cfg\CopyIdentifierComponentSecondPass.java;CopyIdentifierComponentSecondPass.java;220;20;14;6;2;3;0;3
E:\workspace\java\hibernate-orm\hibernate-core\src\main\java\org\hibernate\event\internal\DefaultPersistEventListener.java;DefaultPersistEventListener.java;218;29;17;12;2;3;0;3
E:\workspace\java\hibernate-orm\hibernate-core\src\main\java\org\hibernate\sql\ANSIJoinFragment.java;ANSIJoinFragment.java;218;57;57;0;1;1;0;1
E:\workspace\java\hibernate-orm\hibernate-core\src\main\java\org\hibernate\dialect\SQLServerDialect.java;SQLServerDialect.java;217;5;5;0;1;1;0;1
E:\workspace\java\hibernate-orm\hibernate-core\src\main\java\org\hibernate\hql\internal\ast\tree\BinaryArithmeticOperatorNode.java;BinaryArithmeticOperatorNode.java;217;2;1;1;1;1;0;1
E:\workspace\java\hibernate-orm\hibernate-core\src\main\java\org\hibernate\cfg\annotations\reflection\JPAMetadataProvider.java;JPAMetadataProvider.java;217;309;168;141;2;3;0;3
E:\workspace\java\hibernate-orm\hibernate-core\src\main\java\org\hibernate\cache\spi\access\CachedDomainDataAccess.java;CachedDomainDataAccess.java;216;284;250;34;1;3;0;3
E:\workspace\java\hibernate-orm\hibernate-core\src\main\java\org\hibernate\action\internal\EntityDeleteAction.java;EntityDeleteAction.java;216;16;9;7;2;2;0;2
E:\workspace\java\hibernate-orm\hibernate-core\src\main\java\org\hibernate\query\criteria\internal\expression\BinaryArithmeticOperation.java;BinaryArithmeticOperation.java;216;5;0;5;1;1;0;1
E:\workspace\java\hibernate-orm\hibernate-core\src\main\java\org\hibernate\resource\beans\container\internal\ContainerManagedLifecycleStrategy.java;ContainerManagedLifecycleStrategy.java;215;255;235;20;1;3;0;3
E:\workspace\java\hibernate-orm\hibernate-core\src\main\java\org\hibernate\bytecode\enhance\spi\interceptor\EnhancementHelper.java;EnhancementHelper.java;214;224;219;5;3;3;0;3
E:\workspace\java\hibernate-orm\hibernate-core\src\main\java\org\hibernate\internal\util\collections\CollectionHelper.java;CollectionHelper.java;214;63;55;8;2;2;0;2
E:\workspace\java\hibernate-orm\hibernate-core\src\main\java\org\hibernate\jmx\internal\JmxServiceImpl.java;JmxServiceImpl.java;214;16;14;2;1;2;1;1
E:\workspace\java\hibernate-orm\hibernate-core\src\main\java\org\hibernate\mapping\Constraint.java;Constraint.java;214;2;1;1;1;1;0;1
E:\workspace\java\hibernate-orm\hibernate-core\src\main\java\org\hibernate\bytecode\enhance\internal\javassist\EnhancerImpl.java;EnhancerImpl.java;212;8;4;4;1;1;0;1
E:\workspace\java\hibernate-orm\hibernate-core\src\main\java\org\hibernate\type\OneToOneType.java;OneToOneType.java;212;42;33;9;4;5;0;5
E:\workspace\java\hibernate-orm\hibernate-core\src\main\java\org\hibernate\boot\model\source\internal\hbm\VersionAttributeSourceImpl.java;VersionAttributeSourceImpl.java;211;2;1;1;1;1;0;1
E:\workspace\java\hibernate-orm\hibernate-core\src\main\java\org\hibernate\cache\internal\CollectionCacheInvalidator.java;CollectionCacheInvalidator.java;211;29;21;8;2;3;0;3
E:\workspace\java\hibernate-orm\hibernate-core\src\main\java\org\hibernate\event\spi\LoadEvent.java;LoadEvent.java;210;21;19;2;2;2;1;1
E:\workspace\java\hibernate-orm\hibernate-core\src\main\java\org\hibernate\engine\jdbc\batch\internal\AbstractBatchImpl.java;AbstractBatchImpl.java;209;25;18;7;2;2;0;2
E:\workspace\java\hibernate-orm\hibernate-spatial\src\main\java\org\hibernate\spatial\dialect\postgis\PostgisFunctions.java;PostgisFunctions.java;209;5;5;0;1;1;0;1
E:\workspace\java\hibernate-orm\hibernate-core\src\main\java\org\hibernate\boot\jaxb\internal\stax\JpaOrmXmlEventReader.java;JpaOrmXmlEventReader.java;209;24;13;11;2;2;0;2
E:\workspace\java\hibernate-orm\hibernate-core\src\main\java\org\hibernate\sql\JoinFragment.java;JoinFragment.java;209;17;17;0;1;1;0;1
E:\workspace\java\hibernate-orm\hibernate-jipijapa\src\main\java\org\jboss\as\jpa\hibernate5\management\QueryName.java;QueryName.java;208;576;392;184;1;2;0;2
E:\workspace\java\hibernate-orm\hibernate-core\src\main\java\org\hibernate\engine\query\spi\EntityGraphQueryHint.java;EntityGraphQueryHint.java;208;79;56;23;2;3;0;3
E:\workspace\java\hibernate-orm\hibernate-core\src\main\java\org\hibernate\dialect\Ingres9Dialect.java;Ingres9Dialect.java;208;2;2;0;1;1;0;1
E:\workspace\java\hibernate-orm\hibernate-core\src\main\java\org\hibernate\resource\beans\container\internal\CdiBeanContainerExtendedAccessImpl.java;CdiBeanContainerExtendedAccessImpl.java;207;261;234;27;2;5;0;5
E:\workspace\java\hibernate-orm\hibernate-core\src\main\java\org\hibernate\engine\jdbc\env\spi\IdentifierHelperBuilder.java;IdentifierHelperBuilder.java;206;4;0;4;1;1;0;1
E:\workspace\java\hibernate-orm\hibernate-core\src\main\java\org\hibernate\boot\spi\AbstractDelegatingMetadataBuildingOptions.java;AbstractDelegatingMetadataBuildingOptions.java;205;132;71;61;2;4;0;4
E:\workspace\java\hibernate-orm\hibernate-core\src\main\java\org\hibernate\action\internal\AbstractEntityInsertAction.java;AbstractEntityInsertAction.java;204;16;9;7;2;2;0;2
E:\workspace\java\hibernate-orm\hibernate-core\src\main\java\org\hibernate\graph\internal\AbstractGraph.java;AbstractGraph.java;204;232;218;14;2;3;0;3
E:\workspace\java\hibernate-orm\hibernate-core\src\main\java\org\hibernate\hql\internal\ast\util\ASTPrinter.java;ASTPrinter.java;203;116;54;62;2;4;0;4
E:\workspace\java\hibernate-orm\hibernate-core\src\main\java\org\hibernate\action\internal\EntityAction.java;EntityAction.java;203;39;22;17;3;4;1;3
E:\workspace\java\hibernate-orm\hibernate-envers\src\main\java\org\hibernate\envers\internal\entities\mapper\relation\query\TwoEntityQueryGenerator.java;TwoEntityQueryGenerator.java;203;122;56;66;1;1;1;0
E:\workspace\java\hibernate-orm\hibernate-core\src\main\java\org\hibernate\boot\model\relational\QualifiedNameParser.java;QualifiedNameParser.java;201;9;5;4;1;1;0;1
E:\workspace\java\hibernate-orm\hibernate-core\src\main\java\org\hibernate\hql\spi\id\AbstractTableBasedBulkIdHandler.java;AbstractTableBasedBulkIdHandler.java;201;3;1;2;1;1;0;1
E:\workspace\java\hibernate-orm\hibernate-core\src\main\java\org\hibernate\query\criteria\internal\predicate\InPredicate.java;InPredicate.java;201;13;9;4;2;2;1;1
E:\workspace\java\hibernate-orm\hibernate-core\src\main\java\org\hibernate\SessionBuilder.java;SessionBuilder.java;200;95;51;44;1;1;0;1
E:\workspace\java\hibernate-orm\hibernate-core\src\main\java\org\hibernate\loader\AbstractEntityJoinWalker.java;AbstractEntityJoinWalker.java;200;5;2;3;1;2;0;2
E:\workspace\java\hibernate-orm\hibernate-envers\src\main\java\org\hibernate\envers\internal\entities\PropertyData.java;PropertyData.java;199;36;31;5;2;2;1;1
E:\workspace\java\hibernate-orm\hibernate-core\src\main\java\org\hibernate\jpa\HibernatePersistenceProvider.java;HibernatePersistenceProvider.java;199;20;6;14;1;1;0;1
E:\workspace\java\hibernate-orm\hibernate-core\src\main\java\org\hibernate\jpa\event\internal\CallbackRegistryImpl.java;CallbackRegistryImpl.java;198;11;6;5;2;2;0;2
E:\workspace\java\hibernate-orm\hibernate-core\src\main\java\org\hibernate\type\descriptor\sql\SqlTypeDescriptorRegistry.java;SqlTypeDescriptorRegistry.java;198;91;56;35;1;3;0;3
E:\workspace\java\hibernate-orm\hibernate-core\src\main\java\org\hibernate\action\internal\CollectionAction.java;CollectionAction.java;198;10;5;5;2;2;0;2
E:\workspace\java\hibernate-orm\hibernate-core\src\main\java\org\hibernate\tool\hbm2ddl\SchemaValidator.java;SchemaValidator.java;197;4;1;3;2;2;0;2
E:\workspace\java\hibernate-orm\hibernate-core\src\main\java\org\hibernate\bytecode\enhance\internal\bytebuddy\FieldReaderAppender.java;FieldReaderAppender.java;196;104;67;37;2;4;0;4
E:\workspace\java\hibernate-orm\hibernate-core\src\main\java\org\hibernate\type\descriptor\java\JavaTypeDescriptorRegistry.java;JavaTypeDescriptorRegistry.java;195;111;55;56;2;3;0;3
E:\workspace\java\hibernate-orm\hibernate-core\src\main\java\org\hibernate\SharedSessionContract.java;SharedSessionContract.java;193;6;6;0;1;1;0;1
E:\workspace\java\hibernate-orm\hibernate-core\src\main\java\org\hibernate\dialect\MimerSQLDialect.java;MimerSQLDialect.java;193;9;8;1;1;1;0;1
E:\workspace\java\hibernate-orm\hibernate-core\src\main\java\org\hibernate\engine\spi\SubselectFetch.java;SubselectFetch.java;192;2;1;1;1;1;0;1
E:\workspace\java\hibernate-orm\hibernate-core\src\main\java\org\hibernate\metamodel\model\domain\spi\ManagedTypeDescriptor.java;ManagedTypeDescriptor.java;191;3;3;0;1;1;0;1
E:\workspace\java\hibernate-orm\hibernate-core\src\main\java\org\hibernate\hql\internal\ast\util\SyntheticAndFactory.java;SyntheticAndFactory.java;191;4;2;2;1;2;0;2
E:\workspace\java\hibernate-orm\hibernate-core\src\main\java\org\hibernate\query\procedure\internal\ProcedureParameterMetadata.java;ProcedureParameterMetadata.java;190;5;3;2;1;1;0;1
E:\workspace\java\hibernate-orm\hibernate-core\src\main\java\org\hibernate\boot\model\source\internal\hbm\SingularAttributeSourceBasicImpl.java;SingularAttributeSourceBasicImpl.java;189;4;2;2;1;1;0;1
E:\workspace\java\hibernate-orm\hibernate-core\src\main\java\org\hibernate\tool\schema\Action.java;Action.java;188;10;5;5;2;3;0;3
E:\workspace\java\hibernate-orm\hibernate-core\src\main\java\org\hibernate\jdbc\Expectations.java;Expectations.java;188;12;7;5;1;1;0;1
E:\workspace\java\hibernate-orm\hibernate-envers\src\main\java\org\hibernate\envers\internal\entities\mapper\ComponentPropertyMapper.java;ComponentPropertyMapper.java;187;42;24;18;1;1;0;1
E:\workspace\java\hibernate-orm\hibernate-core\src\main\java\org\hibernate\loader\DefaultEntityAliases.java;DefaultEntityAliases.java;187;52;30;22;3;4;1;3
E:\workspace\java\hibernate-orm\hibernate-envers\src\main\java\org\hibernate\envers\internal\entities\mapper\relation\ToOneIdMapper.java;ToOneIdMapper.java;186;39;35;4;2;2;1;1
E:\workspace\java\hibernate-orm\hibernate-core\src\main\java\org\hibernate\type\BasicTypeRegistry.java;BasicTypeRegistry.java;185;19;18;1;2;3;0;3
E:\workspace\java\hibernate-orm\hibernate-core\src\main\java\org\hibernate\boot\jaxb\internal\AbstractBinder.java;AbstractBinder.java;185;28;14;14;1;2;0;2
E:\workspace\java\hibernate-orm\hibernate-core\src\main\java\org\hibernate\graph\spi\GraphImplementor.java;GraphImplementor.java;185;221;203;18;1;2;0;2
E:\workspace\java\hibernate-orm\hibernate-core\src\main\java\org\hibernate\hql\spi\QueryTranslator.java;QueryTranslator.java;184;9;9;0;1;2;0;2
E:\workspace\java\hibernate-orm\hibernate-envers\src\main\java\org\hibernate\envers\internal\entities\mapper\relation\MapCollectionMapper.java;MapCollectionMapper.java;184;87;87;0;1;2;1;1
E:\workspace\java\hibernate-orm\hibernate-core\src\main\java\org\hibernate\metamodel\spi\MetamodelImplementor.java;MetamodelImplementor.java;183;8;8;0;1;1;0;1
E:\workspace\java\hibernate-orm\hibernate-core\src\main\java\org\hibernate\boot\model\convert\internal\AutoApplicableConverterDescriptorStandardImpl.java;AutoApplicableConverterDescriptorStandardImpl.java;183;4;2;2;1;1;0;1
E:\workspace\java\hibernate-orm\hibernate-core\src\main\java\org\hibernate\query\spi\QueryParameterBindingValidator.java;QueryParameterBindingValidator.java;182;3;3;0;1;1;0;1
E:\workspace\java\hibernate-orm\hibernate-core\src\main\java\org\hibernate\collection\internal\PersistentSortedSet.java;PersistentSortedSet.java;182;23;23;0;1;1;0;1
E:\workspace\java\hibernate-orm\hibernate-core\src\main\java\org\hibernate\dialect\pagination\AbstractLimitHandler.java;AbstractLimitHandler.java;181;9;8;1;1;1;1;0
E:\workspace\java\hibernate-orm\hibernate-core\src\main\java\org\hibernate\query\criteria\internal\compile\CriteriaCompiler.java;CriteriaCompiler.java;181;26;21;5;2;2;0;2
E:\workspace\java\hibernate-orm\hibernate-core\src\main\java\org\hibernate\persister\internal\PersisterFactoryImpl.java;PersisterFactoryImpl.java;181;24;12;12;1;1;0;1
E:\workspace\java\hibernate-orm\hibernate-core\src\main\java\org\hibernate\sql\OracleJoinFragment.java;OracleJoinFragment.java;181;48;48;0;1;1;0;1
E:\workspace\java\hibernate-orm\hibernate-spatial\src\main\java\org\hibernate\spatial\dialect\postgis\PostgisSupport.java;PostgisSupport.java;181;13;9;4;3;3;1;2
E:\workspace\java\hibernate-orm\hibernate-core\src\main\java\org\hibernate\bytecode\enhance\spi\interceptor\LazyAttributeLoadingInterceptor.java;LazyAttributeLoadingInterceptor.java;180;278;60;218;3;3;1;2
E:\workspace\java\hibernate-orm\hibernate-core\src\main\java\org\hibernate\hql\spi\id\TableBasedUpdateHandlerImpl.java;TableBasedUpdateHandlerImpl.java;179;12;6;6;2;3;1;2
E:\workspace\java\hibernate-orm\hibernate-core\src\main\java\org\hibernate\loader\entity\plan\EntityLoader.java;EntityLoader.java;179;81;68;13;1;1;0;1
E:\workspace\java\hibernate-orm\hibernate-core\src\main\java\org\hibernate\jpa\spi\TupleBuilderTransformer.java;TupleBuilderTransformer.java;179;2;1;1;1;1;1;0
E:\workspace\java\hibernate-orm\hibernate-core\src\main\java\org\hibernate\mapping\OneToOne.java;OneToOne.java;178;38;33;5;3;4;1;3
E:\workspace\java\hibernate-orm\hibernate-core\src\main\java\org\hibernate\StatelessSession.java;StatelessSession.java;178;8;7;1;2;2;1;1
E:\workspace\java\hibernate-orm\hibernate-core\src\main\java\org\hibernate\bytecode\enhance\internal\bytebuddy\FieldWriterAppender.java;FieldWriterAppender.java;177;49;25;24;2;2;0;2
E:\workspace\java\hibernate-orm\hibernate-spatial\src\main\java\org\hibernate\spatial\SpatialFunction.java;SpatialFunction.java;177;10;4;6;1;1;0;1
E:\workspace\java\hibernate-orm\hibernate-core\src\main\java\org\hibernate\engine\spi\SessionImplementor.java;SessionImplementor.java;177;15;15;0;2;2;0;2
E:\workspace\java\hibernate-orm\hibernate-core\src\main\java\org\hibernate\boot\cfgxml\internal\ConfigLoader.java;ConfigLoader.java;177;94;47;47;1;2;0;2
E:\workspace\java\hibernate-orm\hibernate-core\src\main\java\org\hibernate\boot\model\naming\NamingHelper.java;NamingHelper.java;177;20;18;2;1;1;0;1
E:\workspace\java\hibernate-orm\hibernate-core\src\main\java\org\hibernate\usertype\CompositeUserType.java;CompositeUserType.java;176;198;99;99;1;2;0;2
E:\workspace\java\hibernate-orm\hibernate-core\src\main\java\org\hibernate\query\QueryProducer.java;QueryProducer.java;176;20;16;4;2;2;0;2
E:\workspace\java\hibernate-orm\hibernate-core\src\main\java\org\hibernate\type\AbstractType.java;AbstractType.java;176;53;37;16;1;2;0;2
E:\workspace\java\hibernate-orm\hibernate-envers\src\main\java\org\hibernate\envers\internal\entities\mapper\SinglePropertyMapper.java;SinglePropertyMapper.java;176;51;29;22;2;2;0;2
E:\workspace\java\hibernate-orm\hibernate-core\src\main\java\org\hibernate\bytecode\enhance\internal\bytebuddy\InlineDirtyCheckingHandler.java;InlineDirtyCheckingHandler.java;176;42;32;10;1;3;0;3
E:\workspace\java\hibernate-orm\hibernate-core\src\main\java\org\hibernate\sql\QueryJoinFragment.java;QueryJoinFragment.java;175;64;56;8;2;3;1;2
E:\workspace\java\hibernate-orm\hibernate-envers\src\main\java\org\hibernate\envers\internal\entities\mapper\relation\ListCollectionMapper.java;ListCollectionMapper.java;175;77;77;0;1;2;1;1
E:\workspace\java\hibernate-orm\hibernate-core\src\main\java\org\hibernate\id\ExportableColumn.java;ExportableColumn.java;175;7;6;1;2;2;1;1
E:\workspace\java\hibernate-orm\hibernate-core\src\main\java\org\hibernate\type\descriptor\sql\BasicExtractor.java;BasicExtractor.java;174;15;6;9;1;1;0;1
E:\workspace\java\hibernate-orm\tooling\hibernate-gradle-plugin\src\main\groovy\org\hibernate\orm\tooling\gradle\EnhancementHelper.java;EnhancementHelper.java;174;174;174;0;1;1;0;1
E:\workspace\java\hibernate-orm\hibernate-core\src\main\java\org\hibernate\query\criteria\internal\predicate\CompoundPredicate.java;CompoundPredicate.java;174;9;0;9;2;2;0;2
E:\workspace\java\hibernate-orm\hibernate-spatial\src\main\java\org\hibernate\spatial\dialect\mysql\MySQL8SpatialFunctions.java;MySQL8SpatialFunctions.java;174;174;174;0;1;1;0;1
E:\workspace\java\hibernate-orm\hibernate-envers\src\main\java\org\hibernate\envers\internal\tools\ReflectionTools.java;ReflectionTools.java;173;40;40;0;1;1;1;0
E:\workspace\java\hibernate-orm\hibernate-core\src\main\java\org\hibernate\event\internal\EntityCopyAllowedLoggedObserver.java;EntityCopyAllowedLoggedObserver.java;173;16;8;8;1;1;0;1
E:\workspace\java\hibernate-orm\hibernate-core\src\main\java\org\hibernate\mapping\OneToMany.java;OneToMany.java;173;42;31;11;2;3;1;2
E:\workspace\java\hibernate-orm\hibernate-core\src\main\java\org\hibernate\boot\spi\BootstrapContext.java;BootstrapContext.java;172;176;174;2;1;5;0;5
E:\workspace\java\hibernate-orm\hibernate-core\src\main\java\org\hibernate\boot\model\relational\Database.java;Database.java;172;31;14;17;1;1;0;1
E:\workspace\java\hibernate-orm\hibernate-core\src\main\java\org\hibernate\type\SpecialOneToOneType.java;SpecialOneToOneType.java;172;46;41;5;2;2;0;2
E:\workspace\java\hibernate-orm\hibernate-core\src\main\java\org\hibernate\query\criteria\internal\AbstractManipulationCriteriaQuery.java;AbstractManipulationCriteriaQuery.java;172;15;12;3;3;3;0;3
E:\workspace\java\hibernate-orm\hibernate-core\src\main\java\org\hibernate\boot\model\source\spi\AbstractAttributeKey.java;AbstractAttributeKey.java;171;12;10;2;1;1;0;1
E:\workspace\java\hibernate-orm\hibernate-core\src\main\java\org\hibernate\engine\jdbc\spi\SqlStatementLogger.java;SqlStatementLogger.java;171;74;74;0;2;3;0;3
E:\workspace\java\hibernate-orm\hibernate-core\src\main\java\org\hibernate\hql\spi\id\TableBasedDeleteHandlerImpl.java;TableBasedDeleteHandlerImpl.java;171;3;1;2;1;1;0;1
E:\workspace\java\hibernate-orm\hibernate-core\src\main\java\org\hibernate\query\criteria\internal\path\MapAttributeJoin.java;MapAttributeJoin.java;171;2;1;1;1;1;0;1
E:\workspace\java\hibernate-orm\hibernate-jipijapa\src\main\java\org\jboss\as\jpa\hibernate5\management\HibernateAbstractStatistics.java;HibernateAbstractStatistics.java;171;379;275;104;1;2;0;2
E:\workspace\java\hibernate-orm\hibernate-core\src\main\java\org\hibernate\cache\spi\entry\StandardCacheEntryImpl.java;StandardCacheEntryImpl.java;169;43;19;24;2;2;0;2
E:\workspace\java\hibernate-orm\hibernate-envers\src\main\java\org\hibernate\envers\internal\entities\mapper\id\VirtualEntitySingleIdMapper.java;VirtualEntitySingleIdMapper.java;168;168;168;0;1;1;1;0
E:\workspace\java\hibernate-orm\hibernate-core\src\main\java\org\hibernate\cache\cfg\internal\DomainDataRegionConfigImpl.java;DomainDataRegionConfigImpl.java;168;168;168;0;2;2;1;1
E:\workspace\java\hibernate-orm\hibernate-core\src\main\java\org\hibernate\graph\internal\parse\GraphParser.java;GraphParser.java;167;167;167;0;1;1;0;1
E:\workspace\java\hibernate-orm\hibernate-core\src\main\java\org\hibernate\boot\model\naming\ImplicitNamingStrategy.java;ImplicitNamingStrategy.java;167;2;1;1;1;1;1;0
E:\workspace\java\hibernate-orm\hibernate-jipijapa\src\main\java\org\jboss\as\jpa\hibernate5\management\HibernateEntityStatistics.java;HibernateEntityStatistics.java;167;395;281;114;1;2;0;2
E:\workspace\java\hibernate-orm\hibernate-core\src\main\java\org\hibernate\tool\schema\internal\Helper.java;Helper.java;166;31;27;4;1;3;0;3
E:\workspace\java\hibernate-orm\hibernate-core\src\main\java\org\hibernate\sql\Sybase11JoinFragment.java;Sybase11JoinFragment.java;166;54;54;0;1;1;0;1
E:\workspace\java\hibernate-orm\hibernate-envers\src\main\java\org\hibernate\envers\internal\entities\mapper\relation\AbstractToOneMapper.java;AbstractToOneMapper.java;166;39;23;16;1;1;0;1
E:\workspace\java\hibernate-orm\hibernate-core\src\main\java\org\hibernate\tool\schema\internal\StandardForeignKeyExporter.java;StandardForeignKeyExporter.java;165;33;23;10;1;1;0;1
E:\workspace\java\hibernate-orm\hibernate-core\src\main\java\org\hibernate\internal\util\ConfigHelper.java;ConfigHelper.java;165;94;47;47;1;2;0;2
E:\workspace\java\hibernate-orm\hibernate-envers\src\main\java\org\hibernate\envers\configuration\internal\metadata\BasicMetadataGenerator.java;BasicMetadataGenerator.java;164;50;18;32;1;2;2;0
E:\workspace\java\hibernate-orm\hibernate-core\src\main\java\org\hibernate\tuple\component\ComponentTuplizerFactory.java;ComponentTuplizerFactory.java;164;19;14;5;1;2;0;2
E:\workspace\java\hibernate-orm\hibernate-envers\src\main\java\org\hibernate\envers\strategy\spi\AuditStrategy.java;AuditStrategy.java;164;164;164;0;1;1;0;1
E:\workspace\java\hibernate-orm\hibernate-core\src\main\java\org\hibernate\event\internal\WrapVisitor.java;WrapVisitor.java;163;34;26;8;2;2;0;2
E:\workspace\java\hibernate-orm\hibernate-core\src\main\java\org\hibernate\usertype\UserType.java;UserType.java;163;90;45;45;2;3;0;3
E:\workspace\java\hibernate-orm\hibernate-core\src\main\java\org\hibernate\loader\collection\BasicCollectionJoinWalker.java;BasicCollectionJoinWalker.java;163;25;14;11;1;2;0;2
E:\workspace\java\hibernate-orm\hibernate-core\src\main\java\org\hibernate\dialect\InterbaseDialect.java;InterbaseDialect.java;161;8;8;0;1;1;0;1
E:\workspace\java\hibernate-orm\hibernate-core\src\main\java\org\hibernate\property\access\spi\SetterMethodImpl.java;SetterMethodImpl.java;161;2;1;1;1;1;0;1
E:\workspace\java\hibernate-orm\hibernate-spatial\src\main\java\org\hibernate\spatial\dialect\h2geodb\GeoDBDialect.java;GeoDBDialect.java;160;9;6;3;2;2;0;2
E:\workspace\java\hibernate-orm\hibernate-core\src\main\java\org\hibernate\bytecode\enhance\spi\interceptor\AbstractInterceptor.java;AbstractInterceptor.java;160;160;160;0;1;1;0;1
E:\workspace\java\hibernate-orm\hibernate-core\src\main\java\org\hibernate\type\descriptor\java\JdbcTimestampTypeDescriptor.java;JdbcTimestampTypeDescriptor.java;160;2;1;1;1;1;0;1
E:\workspace\java\hibernate-orm\hibernate-core\src\main\java\org\hibernate\internal\IteratorImpl.java;IteratorImpl.java;159;10;6;4;1;2;0;2
E:\workspace\java\hibernate-orm\hibernate-core\src\main\java\org\hibernate\cache\spi\support\EntityReadWriteAccess.java;EntityReadWriteAccess.java;159;26;20;6;1;2;0;2
E:\workspace\java\hibernate-orm\hibernate-envers\src\main\java\org\hibernate\envers\internal\entities\mapper\relation\query\OneAuditEntityQueryGenerator.java;OneAuditEntityQueryGenerator.java;158;85;40;45;1;1;1;0
E:\workspace\java\hibernate-orm\hibernate-envers\src\main\java\org\hibernate\envers\internal\entities\mapper\relation\query\AbstractRelationQueryGenerator.java;AbstractRelationQueryGenerator.java;158;127;101;26;1;1;1;0
E:\workspace\java\hibernate-orm\hibernate-spatial\src\main\java\org\hibernate\spatial\dialect\postgis\PostgisPG9Dialect.java;PostgisPG9Dialect.java;157;4;2;2;1;1;1;0
E:\workspace\java\hibernate-orm\hibernate-core\src\main\java\org\hibernate\persister\walking\internal\FetchStrategyHelper.java;FetchStrategyHelper.java;157;2;1;1;1;1;0;1
E:\workspace\java\hibernate-orm\hibernate-core\src\main\java\org\hibernate\cache\internal\TimestampsCacheEnabledImpl.java;TimestampsCacheEnabledImpl.java;157;49;30;19;2;2;0;2
E:\workspace\java\hibernate-orm\hibernate-envers\src\main\java\org\hibernate\envers\strategy\internal\DefaultAuditStrategy.java;DefaultAuditStrategy.java;157;157;157;0;1;1;0;1
E:\workspace\java\hibernate-orm\hibernate-spatial\src\main\java\org\hibernate\spatial\dialect\postgis\PostgisPG91Dialect.java;PostgisPG91Dialect.java;157;4;2;2;1;1;1;0
E:\workspace\java\hibernate-orm\hibernate-core\src\main\java\org\hibernate\cache\spi\AbstractRegionFactory.java;AbstractRegionFactory.java;157;165;161;4;2;4;0;4
E:\workspace\java\hibernate-orm\hibernate-spatial\src\main\java\org\hibernate\spatial\dialect\postgis\PostgisPG94Dialect.java;PostgisPG94Dialect.java;157;4;2;2;1;1;1;0
E:\workspace\java\hibernate-orm\hibernate-spatial\src\main\java\org\hibernate\spatial\dialect\postgis\PostgisPG92Dialect.java;PostgisPG92Dialect.java;157;4;2;2;1;1;1;0
E:\workspace\java\hibernate-orm\hibernate-spatial\src\main\java\org\hibernate\spatial\dialect\postgis\PostgisPG93Dialect.java;PostgisPG93Dialect.java;157;4;2;2;1;1;1;0
E:\workspace\java\hibernate-orm\hibernate-core\src\main\java\org\hibernate\event\internal\DefaultInitializeCollectionEventListener.java;DefaultInitializeCollectionEventListener.java;156;61;34;27;4;6;0;6
E:\workspace\java\hibernate-orm\hibernate-envers\src\main\java\org\hibernate\envers\internal\entities\mapper\SubclassPropertyMapper.java;SubclassPropertyMapper.java;156;2;1;1;1;1;0;1
E:\workspace\java\hibernate-orm\hibernate-spatial\src\main\java\org\hibernate\spatial\dialect\postgis\PostgisPG95Dialect.java;PostgisPG95Dialect.java;156;4;2;2;1;1;1;0
E:\workspace\java\hibernate-orm\hibernate-core\src\main\java\org\hibernate\cache\internal\NaturalIdCacheKey.java;NaturalIdCacheKey.java;156;6;3;3;1;1;0;1
E:\workspace\java\hibernate-orm\hibernate-core\src\main\java\org\hibernate\boot\model\source\internal\hbm\PluralAttributeKeySourceImpl.java;PluralAttributeKeySourceImpl.java;156;42;42;0;1;1;0;1
E:\workspace\java\hibernate-orm\hibernate-core\src\main\java\org\hibernate\engine\jdbc\env\spi\ExtractedDatabaseMetaData.java;ExtractedDatabaseMetaData.java;156;13;13;0;1;1;0;1
E:\workspace\java\hibernate-orm\hibernate-core\src\main\java\org\hibernate\loader\plan\exec\process\internal\CollectionReferenceInitializerImpl.java;CollectionReferenceInitializerImpl.java;156;6;3;3;1;1;0;1
E:\workspace\java\hibernate-orm\hibernate-core\src\main\java\org\hibernate\query\criteria\internal\CriteriaUpdateImpl.java;CriteriaUpdateImpl.java;155;26;17;9;1;1;0;1
E:\workspace\java\hibernate-orm\hibernate-osgi\src\main\java\org\hibernate\osgi\OsgiSessionFactoryService.java;OsgiSessionFactoryService.java;155;11;10;1;1;1;0;1
E:\workspace\java\hibernate-orm\hibernate-core\src\main\java\org\hibernate\engine\jdbc\env\internal\LobCreatorBuilderImpl.java;LobCreatorBuilderImpl.java;154;14;11;3;1;1;0;1
E:\workspace\java\hibernate-orm\hibernate-jipijapa\src\main\java\org\jboss\as\jpa\hibernate5\management\HibernateCollectionStatistics.java;HibernateCollectionStatistics.java;154;368;261;107;1;2;0;2
E:\workspace\java\hibernate-orm\hibernate-core\src\main\java\org\hibernate\type\ArrayType.java;ArrayType.java;153;10;9;1;1;1;0;1
E:\workspace\java\hibernate-orm\hibernate-core\src\main\java\org\hibernate\boot\registry\selector\spi\StrategySelector.java;StrategySelector.java;152;12;11;1;1;3;0;3
E:\workspace\java\hibernate-orm\hibernate-spatial\src\main\java\org\hibernate\spatial\dialect\mysql\MySQL56SpatialDialect.java;MySQL56SpatialDialect.java;152;6;3;3;1;2;0;2
E:\workspace\java\hibernate-orm\hibernate-core\src\main\java\org\hibernate\persister\entity\DiscriminatorType.java;DiscriminatorType.java;152;18;16;2;1;2;0;2
E:\workspace\java\hibernate-orm\hibernate-core\src\main\java\org\hibernate\engine\jdbc\batch\internal\BatchingBatch.java;BatchingBatch.java;152;12;10;2;2;2;0;2
E:\workspace\java\hibernate-orm\hibernate-core\src\main\java\org\hibernate\procedure\ProcedureCall.java;ProcedureCall.java;152;3;2;1;1;1;1;0
E:\workspace\java\hibernate-orm\hibernate-core\src\main\java\org\hibernate\metamodel\model\domain\internal\PluralAttributeBuilder.java;PluralAttributeBuilder.java;152;180;166;14;1;2;0;2
E:\workspace\java\hibernate-orm\hibernate-core\src\main\java\org\hibernate\bytecode\enhance\internal\bytebuddy\FieldAccessEnhancer.java;FieldAccessEnhancer.java;152;57;39;18;2;5;0;5
E:\workspace\java\hibernate-orm\hibernate-core\src\main\java\org\hibernate\query\criteria\internal\path\RootImpl.java;RootImpl.java;151;5;0;5;1;1;0;1
E:\workspace\java\hibernate-orm\hibernate-core\src\main\java\org\hibernate\dialect\TypeNames.java;TypeNames.java;151;22;13;9;1;1;0;1
E:\workspace\java\hibernate-orm\hibernate-core\src\main\java\org\hibernate\type\descriptor\java\OffsetTimeJavaDescriptor.java;OffsetTimeJavaDescriptor.java;151;38;33;5;1;1;1;0
E:\workspace\java\hibernate-orm\hibernate-jipijapa\src\main\java\org\jboss\as\jpa\hibernate5\management\HibernateEntityCacheStatistics.java;HibernateEntityCacheStatistics.java;151;375;263;112;1;3;0;3
E:\workspace\java\hibernate-orm\hibernate-core\src\main\java\org\hibernate\engine\spi\EntityKey.java;EntityKey.java;151;8;6;2;2;2;0;2
E:\workspace\java\hibernate-orm\hibernate-core\src\main\java\org\hibernate\type\descriptor\java\JdbcTimeTypeDescriptor.java;JdbcTimeTypeDescriptor.java;151;2;1;1;1;1;0;1
E:\workspace\java\hibernate-orm\hibernate-core\src\main\java\org\hibernate\resource\transaction\spi\TransactionCoordinator.java;TransactionCoordinator.java;151;4;3;1;1;2;0;2
E:\workspace\java\hibernate-orm\hibernate-core\src\main\java\org\hibernate\event\internal\DefaultResolveNaturalIdEventListener.java;DefaultResolveNaturalIdEventListener.java;150;67;37;30;3;5;1;4
E:\workspace\java\hibernate-orm\hibernate-core\src\main\java\org\hibernate\hql\internal\ast\tree\FromReferenceNode.java;FromReferenceNode.java;150;10;10;0;1;1;0;1
E:\workspace\java\hibernate-orm\hibernate-core\src\main\java\org\hibernate\engine\internal\ParameterBinder.java;ParameterBinder.java;149;3;1;2;1;1;0;1
E:\workspace\java\hibernate-orm\hibernate-core\src\main\java\org\hibernate\boot\jaxb\internal\CacheableFileXmlSource.java;CacheableFileXmlSource.java;148;10;6;4;1;2;2;0
E:\workspace\java\hibernate-orm\hibernate-core\src\main\java\org\hibernate\cfg\annotations\ListBinder.java;ListBinder.java;148;2;1;1;1;1;0;1
E:\workspace\java\hibernate-orm\hibernate-core\src\main\java\org\hibernate\type\descriptor\java\JdbcDateTypeDescriptor.java;JdbcDateTypeDescriptor.java;148;6;3;3;1;1;0;1
E:\workspace\java\hibernate-orm\hibernate-spatial\src\main\java\org\hibernate\spatial\dialect\hana\HANASpatialUtils.java;HANASpatialUtils.java;148;12;7;5;1;1;0;1
E:\workspace\java\hibernate-orm\hibernate-core\src\main\java\org\hibernate\action\internal\CollectionRemoveAction.java;CollectionRemoveAction.java;147;14;9;5;1;1;0;1
E:\workspace\java\hibernate-orm\hibernate-envers\src\main\java\org\hibernate\envers\internal\entities\mapper\relation\query\TwoEntityOneAuditedQueryGenerator.java;TwoEntityOneAuditedQueryGenerator.java;147;102;52;50;1;1;1;0
E:\workspace\java\hibernate-orm\hibernate-core\src\main\java\org\hibernate\proxy\pojo\bytebuddy\ByteBuddyProxyHelper.java;ByteBuddyProxyHelper.java;147;227;187;40;1;3;0;3
E:\workspace\java\hibernate-orm\hibernate-core\src\main\java\org\hibernate\metamodel\model\domain\internal\SingularAttributeImpl.java;SingularAttributeImpl.java;147;181;164;17;1;2;0;2
E:\workspace\java\hibernate-orm\hibernate-core\src\main\java\org\hibernate\type\descriptor\java\ZonedDateTimeJavaDescriptor.java;ZonedDateTimeJavaDescriptor.java;147;56;44;12;2;2;1;1
E:\workspace\java\hibernate-orm\hibernate-core\src\main\java\org\hibernate\type\descriptor\java\InstantJavaDescriptor.java;InstantJavaDescriptor.java;147;55;43;12;2;2;1;1
E:\workspace\java\hibernate-orm\hibernate-core\src\main\java\org\hibernate\annotations\QueryHints.java;QueryHints.java;147;11;9;2;1;1;0;1
E:\workspace\java\hibernate-orm\hibernate-core\src\main\java\org\hibernate\query\criteria\internal\expression\LiteralExpression.java;LiteralExpression.java;147;85;63;22;3;3;0;3
E:\workspace\java\hibernate-orm\hibernate-vibur\src\main\java\org\hibernate\vibur\internal\ViburDBCPConnectionProvider.java;ViburDBCPConnectionProvider.java;147;355;251;104;2;2;1;1
E:\workspace\java\hibernate-orm\hibernate-core\src\main\java\org\hibernate\type\descriptor\java\OffsetDateTimeJavaDescriptor.java;OffsetDateTimeJavaDescriptor.java;147;56;44;12;2;2;1;1
E:\workspace\java\hibernate-orm\hibernate-core\src\main\java\org\hibernate\tool\schema\extract\internal\SequenceInformationExtractorLegacyImpl.java;SequenceInformationExtractorLegacyImpl.java;146;79;74;5;1;1;0;1
E:\workspace\java\hibernate-orm\hibernate-core\src\main\java\org\hibernate\resource\jdbc\internal\AbstractLogicalConnectionImplementor.java;AbstractLogicalConnectionImplementor.java;146;1;1;0;1;1;0;1
E:\workspace\java\hibernate-orm\hibernate-core\src\main\java\org\hibernate\property\access\internal\PropertyAccessStrategyBackRefImpl.java;PropertyAccessStrategyBackRefImpl.java;146;2;1;1;1;1;0;1
E:\workspace\java\hibernate-orm\hibernate-ehcache\src\main\java\org\hibernate\cache\ehcache\internal\StorageAccessImpl.java;StorageAccessImpl.java;145;165;155;10;2;3;0;3
E:\workspace\java\hibernate-orm\hibernate-envers\src\main\java\org\hibernate\envers\internal\entities\mapper\id\EmbeddedIdMapper.java;EmbeddedIdMapper.java;145;4;1;3;1;1;1;0
E:\workspace\java\hibernate-orm\hibernate-core\src\main\java\org\hibernate\mapping\ToOne.java;ToOne.java;144;39;36;3;3;4;2;2
E:\workspace\java\hibernate-orm\hibernate-agroal\src\main\java\org\hibernate\agroal\internal\AgroalConnectionProvider.java;AgroalConnectionProvider.java;144;146;145;1;2;2;0;2
E:\workspace\java\hibernate-orm\hibernate-core\src\main\java\org\hibernate\bytecode\enhance\spi\interceptor\LazyAttributesMetadata.java;LazyAttributesMetadata.java;144;26;15;11;2;2;0;2
E:\workspace\java\hibernate-orm\hibernate-core\src\main\java\org\hibernate\engine\spi\EffectiveEntityGraph.java;EffectiveEntityGraph.java;144;146;145;1;1;2;0;2
E:\workspace\java\hibernate-orm\hibernate-core\src\main\java\org\hibernate\jpa\internal\MutableJpaComplianceImpl.java;MutableJpaComplianceImpl.java;143;143;143;0;1;1;0;1
E:\workspace\java\hibernate-orm\hibernate-core\src\main\java\org\hibernate\hql\internal\ast\tree\AbstractMapComponentNode.java;AbstractMapComponentNode.java;143;24;20;4;2;3;0;3
E:\workspace\java\hibernate-orm\hibernate-spatial\src\main\java\org\hibernate\spatial\dialect\h2geodb\GeoDbWkb.java;GeoDbWkb.java;143;24;12;12;1;2;0;2
E:\workspace\java\hibernate-orm\hibernate-core\src\main\java\org\hibernate\resource\beans\internal\ManagedBeanRegistryImpl.java;ManagedBeanRegistryImpl.java;142;166;154;12;2;3;0;3
E:\workspace\java\hibernate-orm\hibernate-core\src\main\java\org\hibernate\id\IncrementGenerator.java;IncrementGenerator.java;142;5;2;3;1;1;0;1
E:\workspace\java\hibernate-orm\hibernate-core\src\main\java\org\hibernate\proxy\pojo\bytebuddy\SerializableProxy.java;SerializableProxy.java;142;37;34;3;1;2;0;2
E:\workspace\java\hibernate-orm\hibernate-core\src\main\java\org\hibernate\hql\spi\id\inline\AbstractInlineIdsUpdateHandlerImpl.java;AbstractInlineIdsUpdateHandlerImpl.java;141;25;14;11;1;3;1;2
E:\workspace\java\hibernate-orm\hibernate-core\src\main\java\org\hibernate\loader\GeneratedCollectionAliases.java;GeneratedCollectionAliases.java;141;3;1;2;1;1;0;1
E:\workspace\java\hibernate-orm\hibernate-core\src\main\java\org\hibernate\dialect\lock\UpdateLockingStrategy.java;UpdateLockingStrategy.java;141;33;21;12;1;1;0;1
E:\workspace\java\hibernate-orm\hibernate-core\src\main\java\org\hibernate\proxy\pojo\javassist\SerializableProxy.java;SerializableProxy.java;141;25;23;2;1;1;0;1
E:\workspace\java\hibernate-orm\hibernate-envers\src\main\java\org\hibernate\envers\configuration\internal\EntitiesConfigurator.java;EntitiesConfigurator.java;140;8;4;4;1;2;0;2
E:\workspace\java\hibernate-orm\hibernate-core\src\main\java\org\hibernate\loader\entity\plan\LegacyBatchingEntityLoaderBuilder.java;LegacyBatchingEntityLoaderBuilder.java;140;33;20;13;2;2;0;2
E:\workspace\java\hibernate-orm\hibernate-core\src\main\java\org\hibernate\type\descriptor\java\SerializableTypeDescriptor.java;SerializableTypeDescriptor.java;140;13;6;7;2;2;0;2
E:\workspace\java\hibernate-orm\hibernate-core\src\main\java\org\hibernate\engine\transaction\jta\platform\internal\StandardJtaPlatformResolver.java;StandardJtaPlatformResolver.java;140;53;44;9;3;5;0;5
E:\workspace\java\hibernate-orm\hibernate-core\src\main\java\org\hibernate\engine\spi\CollectionKey.java;CollectionKey.java;139;14;6;8;1;1;0;1
E:\workspace\java\hibernate-orm\hibernate-core\src\main\java\org\hibernate\type\descriptor\java\LocalDateJavaDescriptor.java;LocalDateJavaDescriptor.java;139;16;15;1;1;1;1;0
E:\workspace\java\hibernate-orm\hibernate-core\src\main\java\org\hibernate\jpa\QueryHints.java;QueryHints.java;139;14;10;4;1;1;0;1
E:\workspace\java\hibernate-orm\hibernate-core\src\main\java\org\hibernate\bytecode\enhance\spi\EnhancementContext.java;EnhancementContext.java;139;4;2;2;1;1;1;0
E:\workspace\java\hibernate-orm\hibernate-core\src\main\java\org\hibernate\dialect\lock\PessimisticReadUpdateLockingStrategy.java;PessimisticReadUpdateLockingStrategy.java;139;16;10;6;1;1;0;1
E:\workspace\java\hibernate-orm\hibernate-core\src\main\java\org\hibernate\hql\internal\ast\ParameterTranslationsImpl.java;ParameterTranslationsImpl.java;138;47;39;8;2;2;0;2
E:\workspace\java\hibernate-orm\hibernate-core\src\main\java\org\hibernate\exception\internal\SQLStateConversionDelegate.java;SQLStateConversionDelegate.java;138;9;3;6;1;1;0;1
E:\workspace\java\hibernate-orm\hibernate-core\src\main\java\org\hibernate\cfg\IndexOrUniqueKeySecondPass.java;IndexOrUniqueKeySecondPass.java;138;8;4;4;1;2;1;1
E:\workspace\java\hibernate-orm\hibernate-core\src\main\java\org\hibernate\boot\xsd\ConfigXsdSupport.java;ConfigXsdSupport.java;137;229;183;46;4;4;0;4
E:\workspace\java\hibernate-orm\hibernate-core\src\main\java\org\hibernate\hql\spi\id\cte\CteValuesListUpdateHandlerImpl.java;CteValuesListUpdateHandlerImpl.java;137;10;5;5;1;2;1;1
E:\workspace\java\hibernate-orm\hibernate-core\src\main\java\org\hibernate\query\criteria\internal\expression\SimpleCaseExpression.java;SimpleCaseExpression.java;137;52;19;33;3;4;0;4
E:\workspace\java\hibernate-orm\hibernate-core\src\main\java\org\hibernate\dialect\lock\PessimisticWriteUpdateLockingStrategy.java;PessimisticWriteUpdateLockingStrategy.java;137;16;10;6;1;1;0;1
E:\workspace\java\hibernate-orm\hibernate-core\src\main\java\org\hibernate\loader\custom\ColumnCollectionAliases.java;ColumnCollectionAliases.java;136;3;1;2;1;1;0;1
E:\workspace\java\hibernate-orm\hibernate-spatial\src\main\java\org\hibernate\spatial\dialect\mysql\MySQLSpatialDialect.java;MySQLSpatialDialect.java;136;7;6;1;2;2;0;2
E:\workspace\java\hibernate-orm\hibernate-envers\src\main\java\org\hibernate\envers\internal\entities\mapper\relation\query\OneEntityQueryGenerator.java;OneEntityQueryGenerator.java;136;99;51;48;1;1;1;0
E:\workspace\java\hibernate-orm\hibernate-core\src\main\java\org\hibernate\context\internal\ManagedSessionContext.java;ManagedSessionContext.java;136;6;3;3;1;1;0;1
E:\workspace\java\hibernate-orm\hibernate-core\src\main\java\org\hibernate\boot\model\TypeDefinition.java;TypeDefinition.java;136;9;4;5;1;1;0;1
E:\workspace\java\hibernate-orm\hibernate-core\src\main\java\org\hibernate\event\internal\DefaultEvictEventListener.java;DefaultEvictEventListener.java;136;17;10;7;2;2;0;2
E:\workspace\java\hibernate-orm\hibernate-envers\src\main\java\org\hibernate\envers\configuration\EnversSettings.java;EnversSettings.java;136;14;14;0;1;1;1;0
E:\workspace\java\hibernate-orm\hibernate-spatial\src\main\java\org\hibernate\spatial\dialect\postgis\PGGeometryTypeDescriptor.java;PGGeometryTypeDescriptor.java;136;72;36;36;1;1;0;1
E:\workspace\java\hibernate-orm\hibernate-core\src\main\java\org\hibernate\internal\EntityManagerMessageLogger.java;EntityManagerMessageLogger.java;136;2;1;1;1;1;0;1
E:\workspace\java\hibernate-orm\hibernate-envers\src\main\java\org\hibernate\envers\query\internal\impl\EntitiesAtRevisionQuery.java;EntitiesAtRevisionQuery.java;135;5;5;0;1;1;1;0
E:\workspace\java\hibernate-orm\hibernate-core\src\main\java\org\hibernate\type\descriptor\java\LocalDateTimeJavaDescriptor.java;LocalDateTimeJavaDescriptor.java;135;19;16;3;1;1;1;0
E:\workspace\java\hibernate-orm\hibernate-core\src\main\java\org\hibernate\proxy\pojo\javassist\JavassistLazyInitializer.java;JavassistLazyInitializer.java;135;4;3;1;2;2;0;2
E:\workspace\java\hibernate-orm\hibernate-core\src\main\java\org\hibernate\tuple\component\ComponentMetamodel.java;ComponentMetamodel.java;135;21;15;6;1;2;0;2
E:\workspace\java\hibernate-orm\hibernate-core\src\main\java\org\hibernate\type\TypeResolver.java;TypeResolver.java;134;54;34;20;2;3;1;2
E:\workspace\java\hibernate-orm\hibernate-core\src\main\java\org\hibernate\jpa\internal\JpaComplianceImpl.java;JpaComplianceImpl.java;134;152;78;74;1;1;0;1
E:\workspace\java\hibernate-orm\hibernate-core\src\main\java\org\hibernate\jpa\spi\HibernateEntityManagerImplementor.java;HibernateEntityManagerImplementor.java;133;2;1;1;1;1;0;1
E:\workspace\java\hibernate-orm\hibernate-core\src\main\java\org\hibernate\cfg\annotations\IdBagBinder.java;IdBagBinder.java;133;32;22;10;1;2;0;2
E:\workspace\java\hibernate-orm\hibernate-core\src\main\java\org\hibernate\loader\collection\OneToManyJoinWalker.java;OneToManyJoinWalker.java;133;3;1;2;1;1;0;1
E:\workspace\java\hibernate-orm\hibernate-core\src\main\java\org\hibernate\sql\Insert.java;Insert.java;133;36;24;12;3;4;2;2
E:\workspace\java\hibernate-orm\hibernate-core\src\main\java\org\hibernate\boot\registry\internal\StandardServiceRegistryImpl.java;StandardServiceRegistryImpl.java;132;55;45;10;2;2;0;2
E:\workspace\java\hibernate-orm\hibernate-core\src\main\java\org\hibernate\query\criteria\internal\expression\function\TrimFunction.java;TrimFunction.java;132;43;24;19;1;1;0;1
E:\workspace\java\hibernate-orm\hibernate-core\src\main\java\org\hibernate\resource\beans\spi\ManagedBeanRegistryInitiator.java;ManagedBeanRegistryInitiator.java;132;66;57;9;2;2;1;1
E:\workspace\java\hibernate-orm\hibernate-core\src\main\java\org\hibernate\id\insert\AbstractSelectingDelegate.java;AbstractSelectingDelegate.java;131;2;1;1;1;1;1;0
E:\workspace\java\hibernate-orm\hibernate-core\src\main\java\org\hibernate\type\descriptor\sql\BasicBinder.java;BasicBinder.java;131;10;4;6;1;1;0;1
E:\workspace\java\hibernate-orm\hibernate-core\src\main\java\org\hibernate\cache\internal\RegionFactoryInitiator.java;RegionFactoryInitiator.java;131;179;105;74;1;5;0;5
E:\workspace\java\hibernate-orm\hibernate-core\src\main\java\org\hibernate\engine\spi\VersionValue.java;VersionValue.java;131;2;1;1;1;1;1;0
E:\workspace\java\hibernate-orm\hibernate-core\src\main\java\org\hibernate\action\internal\CollectionUpdateAction.java;CollectionUpdateAction.java;131;17;11;6;2;3;0;3
E:\workspace\java\hibernate-orm\hibernate-core\src\main\java\org\hibernate\internal\FilterHelper.java;FilterHelper.java;131;28;17;11;1;1;0;1
E:\workspace\java\hibernate-orm\hibernate-core\src\main\java\org\hibernate\loader\entity\PaddedBatchingEntityLoaderBuilder.java;PaddedBatchingEntityLoaderBuilder.java;130;2;1;1;1;1;0;1
E:\workspace\java\hibernate-orm\hibernate-core\src\main\java\org\hibernate\dialect\SQLServer2005Dialect.java;SQLServer2005Dialect.java;130;5;5;0;1;1;0;1
E:\workspace\java\hibernate-orm\hibernate-core\src\main\java\org\hibernate\metamodel\model\domain\internal\AbstractAttribute.java;AbstractAttribute.java;130;21;11;10;1;1;0;1
E:\workspace\java\hibernate-orm\hibernate-core\src\main\java\org\hibernate\procedure\internal\ParameterBindImpl.java;ParameterBindImpl.java;129;23;17;6;2;3;0;3
E:\workspace\java\hibernate-orm\hibernate-core\src\main\java\org\hibernate\property\access\internal\PropertyAccessStrategyIndexBackRefImpl.java;PropertyAccessStrategyIndexBackRefImpl.java;129;2;1;1;1;1;0;1
E:\workspace\java\hibernate-orm\hibernate-spatial\src\main\java\org\hibernate\spatial\dialect\hana\HANASpatialFunctions.java;HANASpatialFunctions.java;129;129;129;0;1;1;0;1
E:\workspace\java\hibernate-orm\hibernate-core\src\main\java\org\hibernate\cache\spi\support\NaturalIdReadWriteAccess.java;NaturalIdReadWriteAccess.java;129;26;20;6;1;2;0;2
E:\workspace\java\hibernate-orm\hibernate-core\src\main\java\org\hibernate\type\descriptor\java\JavaTypeDescriptor.java;JavaTypeDescriptor.java;128;44;29;15;2;2;0;2
E:\workspace\java\hibernate-orm\hibernate-core\src\main\java\org\hibernate\type\CustomCollectionType.java;CustomCollectionType.java;128;14;13;1;2;2;0;2
E:\workspace\java\hibernate-orm\hibernate-core\src\main\java\org\hibernate\query\criteria\internal\expression\SearchedCaseExpression.java;SearchedCaseExpression.java;128;60;25;35;3;5;0;5
E:\workspace\java\hibernate-orm\hibernate-core\src\main\java\org\hibernate\id\enhanced\PooledLoThreadLocalOptimizer.java;PooledLoThreadLocalOptimizer.java;128;14;4;10;1;1;0;1
E:\workspace\java\hibernate-orm\hibernate-core\src\main\java\org\hibernate\query\criteria\internal\expression\function\ParameterizedFunctionExpression.java;ParameterizedFunctionExpression.java;128;33;21;12;2;3;0;3
E:\workspace\java\hibernate-orm\hibernate-core\src\main\java\org\hibernate\MultiIdentifierLoadAccess.java;MultiIdentifierLoadAccess.java;128;11;10;1;2;2;0;2
E:\workspace\java\hibernate-orm\hibernate-core\src\main\java\org\hibernate\SharedSessionBuilder.java;SharedSessionBuilder.java;128;35;35;0;1;1;0;1
E:\workspace\java\hibernate-orm\hibernate-core\src\main\java\org\hibernate\hql\spi\id\inline\IdsClauseBuilder.java;IdsClauseBuilder.java;127;26;26;0;1;1;0;1
E:\workspace\java\hibernate-orm\hibernate-core\src\main\java\org\hibernate\sql\ForUpdateFragment.java;ForUpdateFragment.java;126;4;2;2;1;1;0;1
E:\workspace\java\hibernate-orm\hibernate-core\src\main\java\org\hibernate\engine\query\spi\NativeSQLQueryPlan.java;NativeSQLQueryPlan.java;126;5;5;0;1;1;0;1
E:\workspace\java\hibernate-orm\hibernate-envers\src\main\java\org\hibernate\envers\boot\internal\AdditionalJaxbMappingProducerImpl.java;AdditionalJaxbMappingProducerImpl.java;126;18;10;8;1;3;0;3
E:\workspace\java\hibernate-orm\hibernate-core\src\main\java\org\hibernate\proxy\map\MapProxy.java;MapProxy.java;126;49;45;4;1;2;0;2
E:\workspace\java\hibernate-orm\hibernate-core\src\main\java\org\hibernate\loader\entity\LegacyBatchingEntityLoaderBuilder.java;LegacyBatchingEntityLoaderBuilder.java;126;2;1;1;1;1;0;1
E:\workspace\java\hibernate-orm\hibernate-envers\src\main\java\org\hibernate\envers\internal\entities\mapper\MultiDynamicComponentMapper.java;MultiDynamicComponentMapper.java;125;38;19;19;1;1;0;1
E:\workspace\java\hibernate-orm\hibernate-core\src\main\java\org\hibernate\resource\beans\container\internal\CdiBeanContainerDelayedAccessImpl.java;CdiBeanContainerDelayedAccessImpl.java;125;135;130;5;1;3;0;3
E:\workspace\java\hibernate-orm\hibernate-core\src\main\java\org\hibernate\stat\internal\NaturalIdStatisticsImpl.java;NaturalIdStatisticsImpl.java;124;18;7;11;2;2;0;2
E:\workspace\java\hibernate-orm\hibernate-spatial\src\main\java\org\hibernate\spatial\dialect\mysql\MySQL8SpatialDialect.java;MySQL8SpatialDialect.java;124;124;124;0;1;1;0;1
E:\workspace\java\hibernate-orm\hibernate-core\src\main\java\org\hibernate\engine\jdbc\connections\spi\DataSourceBasedMultiTenantConnectionProviderImpl.java;DataSourceBasedMultiTenantConnectionProviderImpl.java;124;2;1;1;1;1;0;1
E:\workspace\java\hibernate-orm\hibernate-core\src\main\java\org\hibernate\dialect\SybaseASE157Dialect.java;SybaseASE157Dialect.java;124;19;19;0;1;1;0;1
E:\workspace\java\hibernate-orm\hibernate-core\src\main\java\org\hibernate\internal\util\EntityPrinter.java;EntityPrinter.java;124;16;12;4;2;2;1;1
E:\workspace\java\hibernate-orm\hibernate-core\src\main\java\org\hibernate\dialect\MySQL8Dialect.java;MySQL8Dialect.java;123;123;123;0;3;4;0;4
E:\workspace\java\hibernate-orm\hibernate-core\src\main\java\org\hibernate\dialect\lock\PessimisticWriteSelectLockingStrategy.java;PessimisticWriteSelectLockingStrategy.java;123;31;18;13;1;1;0;1
E:\workspace\java\hibernate-orm\hibernate-core\src\main\java\org\hibernate\cache\spi\access\NaturalIdDataAccess.java;NaturalIdDataAccess.java;123;1;1;0;1;1;0;1
E:\workspace\java\hibernate-orm\hibernate-core\src\main\java\org\hibernate\loader\plan\exec\internal\BatchingLoadQueryDetailsFactory.java;BatchingLoadQueryDetailsFactory.java;123;21;19;2;2;2;0;2
E:\workspace\java\hibernate-orm\hibernate-envers\src\main\java\org\hibernate\envers\internal\entities\mapper\id\MultipleIdMapper.java;MultipleIdMapper.java;122;40;38;2;1;1;1;0
E:\workspace\java\hibernate-orm\hibernate-spatial\src\main\java\org\hibernate\spatial\dialect\hana\HANASpatialFunction.java;HANASpatialFunction.java;122;142;93;49;1;2;1;1
E:\workspace\java\hibernate-orm\hibernate-spatial\src\main\java\org\hibernate\spatial\dialect\sqlserver\SqlServer2008GeometryTypeDescriptor.java;SqlServer2008GeometryTypeDescriptor.java;122;13;6;7;1;1;0;1
E:\workspace\java\hibernate-orm\hibernate-core\src\main\java\org\hibernate\cfg\beanvalidation\GroupsPerOperation.java;GroupsPerOperation.java;121;2;1;1;1;1;0;1
E:\workspace\java\hibernate-orm\hibernate-core\src\main\java\org\hibernate\exception\spi\SQLExceptionConverterFactory.java;SQLExceptionConverterFactory.java;120;5;3;2;1;1;0;1
E:\workspace\java\hibernate-orm\hibernate-core\src\main\java\org\hibernate\event\spi\AbstractCollectionEvent.java;AbstractCollectionEvent.java;120;10;5;5;1;1;0;1
E:\workspace\java\hibernate-orm\hibernate-core\src\main\java\org\hibernate\dialect\lock\PessimisticReadSelectLockingStrategy.java;PessimisticReadSelectLockingStrategy.java;120;46;23;23;1;2;0;2
E:\workspace\java\hibernate-orm\hibernate-envers\src\main\java\org\hibernate\envers\internal\entities\mapper\id\IdMapper.java;IdMapper.java;119;6;6;0;1;1;1;0
E:\workspace\java\hibernate-orm\hibernate-core\src\main\java\org\hibernate\id\uuid\Helper.java;Helper.java;119;17;2;15;2;2;0;2
E:\workspace\java\hibernate-orm\hibernate-core\src\main\java\org\hibernate\dialect\lock\SelectLockingStrategy.java;SelectLockingStrategy.java;119;31;18;13;1;1;0;1
E:\workspace\java\hibernate-orm\hibernate-core\src\main\java\org\hibernate\loader\entity\CollectionElementLoader.java;CollectionElementLoader.java;119;2;1;1;1;1;0;1
E:\workspace\java\hibernate-orm\hibernate-core\src\main\java\org\hibernate\graph\Graph.java;Graph.java;119;119;119;0;1;1;0;1
E:\workspace\java\hibernate-orm\hibernate-core\src\main\java\org\hibernate\boot\xsd\LocalXsdResolver.java;LocalXsdResolver.java;118;142;130;12;3;3;0;3
E:\workspace\java\hibernate-orm\hibernate-core\src\main\java\org\hibernate\boot\jaxb\internal\MappingBinder.java;MappingBinder.java;118;15;8;7;2;2;0;2
E:\workspace\java\hibernate-orm\hibernate-core\src\main\java\org\hibernate\query\criteria\internal\path\AbstractJoinImpl.java;AbstractJoinImpl.java;118;4;2;2;1;1;1;0
E:\workspace\java\hibernate-orm\hibernate-core\src\main\java\org\hibernate\bytecode\enhance\internal\bytebuddy\ByteBuddyEnhancementContext.java;ByteBuddyEnhancementContext.java;118;103;71;32;1;3;0;3
E:\workspace\java\hibernate-orm\hibernate-spatial\src\main\java\org\hibernate\spatial\dialect\sqlserver\SqlServerSupport.java;SqlServerSupport.java;117;117;117;0;1;2;1;1
E:\workspace\java\hibernate-orm\hibernate-ehcache\src\main\java\org\hibernate\cache\ehcache\internal\EhCacheMessageLogger.java;EhCacheMessageLogger.java;116;144;130;14;2;4;0;4
E:\workspace\java\hibernate-orm\hibernate-core\src\main\java\org\hibernate\engine\jdbc\internal\JdbcServicesImpl.java;JdbcServicesImpl.java;116;3;2;1;1;1;0;1
E:\workspace\java\hibernate-orm\hibernate-core\src\main\java\org\hibernate\proxy\pojo\BasicLazyInitializer.java;BasicLazyInitializer.java;116;18;6;12;1;2;0;2
E:\workspace\java\hibernate-orm\hibernate-core\src\main\java\org\hibernate\internal\util\xml\DTDEntityResolver.java;DTDEntityResolver.java;115;1;0;1;1;1;0;1
E:\workspace\java\hibernate-orm\hibernate-core\src\main\java\org\hibernate\cfg\ToOneFkSecondPass.java;ToOneFkSecondPass.java;115;1;1;0;1;1;1;0
E:\workspace\java\hibernate-orm\hibernate-core\src\main\java\org\hibernate\tool\schema\extract\internal\SequenceInformationExtractorMariaDBDatabaseImpl.java;SequenceInformationExtractorMariaDBDatabaseImpl.java;115;115;115;0;1;1;0;1
E:\workspace\java\hibernate-orm\hibernate-core\src\main\java\org\hibernate\query\criteria\internal\expression\function\SubstringFunction.java;SubstringFunction.java;115;28;18;10;1;1;0;1
E:\workspace\java\hibernate-orm\hibernate-core\src\main\java\org\hibernate\hql\internal\ast\exec\DeleteExecutor.java;DeleteExecutor.java;115;17;10;7;2;2;0;2
E:\workspace\java\hibernate-orm\hibernate-core\src\main\java\org\hibernate\mapping\ManyToOne.java;ManyToOne.java;115;20;15;5;2;3;1;2
E:\workspace\java\hibernate-orm\hibernate-spatial\src\main\java\org\hibernate\spatial\dialect\db2\DB2GeometryTypeDescriptor.java;DB2GeometryTypeDescriptor.java;115;127;121;6;1;2;0;2
E:\workspace\java\hibernate-orm\hibernate-core\src\main\java\org\hibernate\jpa\boot\spi\ProviderChecker.java;ProviderChecker.java;114;33;16;17;1;2;0;2
E:\workspace\java\hibernate-orm\hibernate-core\src\main\java\org\hibernate\engine\jdbc\env\internal\DefaultSchemaNameResolver.java;DefaultSchemaNameResolver.java;113;149;69;80;3;3;0;3
E:\workspace\java\hibernate-orm\hibernate-core\src\main\java\org\hibernate\cache\spi\support\AbstractCachedDomainDataAccess.java;AbstractCachedDomainDataAccess.java;113;40;13;27;2;3;1;2
E:\workspace\java\hibernate-orm\hibernate-envers\src\main\java\org\hibernate\envers\internal\revisioninfo\DefaultRevisionInfoGenerator.java;DefaultRevisionInfoGenerator.java;112;2;1;1;1;1;0;1
E:\workspace\java\hibernate-orm\hibernate-core\src\main\java\org\hibernate\persister\entity\Joinable.java;Joinable.java;112;13;13;0;1;1;0;1
E:\workspace\java\hibernate-orm\hibernate-core\src\main\java\org\hibernate\resource\jdbc\spi\PhysicalConnectionHandlingMode.java;PhysicalConnectionHandlingMode.java;112;4;2;2;1;1;0;1
E:\workspace\java\hibernate-orm\hibernate-core\src\main\java\org\hibernate\loader\custom\JdbcResultMetadata.java;JdbcResultMetadata.java;112;39;33;6;1;1;0;1
E:\workspace\java\hibernate-orm\hibernate-core\src\main\java\org\hibernate\procedure\ParameterRegistration.java;ParameterRegistration.java;112;15;15;0;1;2;0;2
E:\workspace\java\hibernate-orm\hibernate-core\src\main\java\org\hibernate\id\uuid\CustomVersionOneStrategy.java;CustomVersionOneStrategy.java;111;4;3;1;1;1;0;1
E:\workspace\java\hibernate-orm\hibernate-core\src\main\java\org\hibernate\loader\entity\AbstractEntityLoader.java;AbstractEntityLoader.java;111;4;2;2;1;1;0;1
E:\workspace\java\hibernate-orm\hibernate-core\src\main\java\org\hibernate\mapping\IndexedCollection.java;IndexedCollection.java;111;36;28;8;2;4;2;2
E:\workspace\java\hibernate-orm\hibernate-core\src\main\java\org\hibernate\query\criteria\internal\expression\function\LocateFunction.java;LocateFunction.java;111;30;20;10;1;1;0;1
E:\workspace\java\hibernate-orm\hibernate-core\src\main\java\org\hibernate\hql\spi\id\AbstractIdsBulkIdHandler.java;AbstractIdsBulkIdHandler.java;110;8;6;2;1;1;0;1
E:\workspace\java\hibernate-orm\hibernate-core\src\main\java\org\hibernate\cfg\beanvalidation\HibernateTraversableResolver.java;HibernateTraversableResolver.java;109;4;2;2;1;1;0;1
E:\workspace\java\hibernate-orm\hibernate-envers\src\main\java\org\hibernate\envers\configuration\internal\metadata\QueryGeneratorBuilder.java;QueryGeneratorBuilder.java;109;16;9;7;1;1;1;0
E:\workspace\java\hibernate-orm\hibernate-core\src\main\java\org\hibernate\loader\BasicLoader.java;BasicLoader.java;109;5;3;2;1;2;1;1
E:\workspace\java\hibernate-orm\hibernate-core\src\main\java\org\hibernate\boot\model\relational\SimpleAuxiliaryDatabaseObject.java;SimpleAuxiliaryDatabaseObject.java;109;8;8;0;1;1;0;1
E:\workspace\java\hibernate-orm\hibernate-core\src\main\java\org\hibernate\cfg\BaselineSessionEventsListenerBuilder.java;BaselineSessionEventsListenerBuilder.java;109;69;55;14;1;1;0;1
E:\workspace\java\hibernate-orm\hibernate-spatial\src\main\java\org\hibernate\spatial\dialect\mysql\MySQLGeometryTypeDescriptor.java;MySQLGeometryTypeDescriptor.java;109;14;7;7;1;1;0;1
E:\workspace\java\hibernate-orm\hibernate-core\src\main\java\org\hibernate\service\internal\SessionFactoryServiceRegistryImpl.java;SessionFactoryServiceRegistryImpl.java;107;56;40;16;3;4;0;4
E:\workspace\java\hibernate-orm\hibernate-core\src\main\java\org\hibernate\type\descriptor\sql\LobTypeMappings.java;LobTypeMappings.java;107;116;76;40;1;2;0;2
E:\workspace\java\hibernate-orm\hibernate-core\src\main\java\org\hibernate\type\descriptor\java\AbstractTypeDescriptor.java;AbstractTypeDescriptor.java;107;13;9;4;2;3;0;3
E:\workspace\java\hibernate-orm\hibernate-core\src\main\java\org\hibernate\resource\beans\container\internal\CdiBeanContainerBuilder.java;CdiBeanContainerBuilder.java;107;12;6;6;2;3;0;3
E:\workspace\java\hibernate-orm\hibernate-core\src\main\java\org\hibernate\boot\jaxb\internal\stax\LocalSchema.java;LocalSchema.java;107;4;4;0;1;1;0;1
E:\workspace\java\hibernate-orm\hibernate-core\src\main\java\org\hibernate\tool\schema\internal\exec\ScriptSourceInputFromFile.java;ScriptSourceInputFromFile.java;107;5;5;0;1;1;0;1
E:\workspace\java\hibernate-orm\hibernate-envers\src\main\java\org\hibernate\envers\internal\entities\mapper\relation\lazy\initializor\ListCollectionInitializor.java;ListCollectionInitializor.java;106;52;39;13;1;1;1;0
E:\workspace\java\hibernate-orm\hibernate-envers\src\main\java\org\hibernate\envers\internal\synchronization\work\AbstractAuditWorkUnit.java;AbstractAuditWorkUnit.java;106;6;5;1;1;1;1;0
E:\workspace\java\hibernate-orm\hibernate-core\src\main\java\org\hibernate\internal\util\io\CharSequenceReader.java;CharSequenceReader.java;106;106;106;0;1;1;0;1
E:\workspace\java\hibernate-orm\hibernate-core\src\main\java\org\hibernate\graph\internal\RootGraphImpl.java;RootGraphImpl.java;106;118;112;6;1;2;0;2
E:\workspace\java\hibernate-orm\hibernate-core\src\main\java\org\hibernate\property\access\spi\SetterFieldImpl.java;SetterFieldImpl.java;106;2;1;1;1;1;0;1
E:\workspace\java\hibernate-orm\hibernate-core\src\main\java\org\hibernate\boot\model\Caching.java;Caching.java;106;2;1;1;1;1;0;1
E:\workspace\java\hibernate-orm\hibernate-core\src\main\java\org\hibernate\cache\spi\RegionFactory.java;RegionFactory.java;106;244;43;201;2;3;0;3
E:\workspace\java\hibernate-orm\hibernate-core\src\main\java\org\hibernate\stat\internal\AbstractCacheableDataStatistics.java;AbstractCacheableDataStatistics.java;105;159;132;27;3;4;0;4
E:\workspace\java\hibernate-orm\hibernate-core\src\main\java\org\hibernate\proxy\pojo\bytebuddy\ByteBuddyProxyFactory.java;ByteBuddyProxyFactory.java;105;253;69;184;3;9;0;9
E:\workspace\java\hibernate-orm\hibernate-core\src\main\java\org\hibernate\stat\internal\StatisticsInitiator.java;StatisticsInitiator.java;105;49;31;18;2;4;0;4
E:\workspace\java\hibernate-orm\hibernate-core\src\main\java\org\hibernate\query\criteria\internal\predicate\NegatedPredicateWrapper.java;NegatedPredicateWrapper.java;105;5;0;5;1;1;0;1
E:\workspace\java\hibernate-orm\hibernate-core\src\main\java\org\hibernate\event\internal\DefaultLockEventListener.java;DefaultLockEventListener.java;105;12;7;5;1;1;0;1
E:\workspace\java\hibernate-orm\hibernate-core\src\main\java\org\hibernate\mapping\Any.java;Any.java;105;43;38;5;3;4;1;3
E:\workspace\java\hibernate-orm\hibernate-core\src\main\java\org\hibernate\graph\RootGraph.java;RootGraph.java;105;105;105;0;1;1;0;1
E:\workspace\java\hibernate-orm\hibernate-spatial\src\main\java\org\hibernate\spatial\dialect\oracle\OracleSpatial10gDialect.java;OracleSpatial10gDialect.java;105;14;3;11;1;1;0;1
E:\workspace\java\hibernate-orm\hibernate-core\src\main\java\org\hibernate\type\PostgresUUIDType.java;PostgresUUIDType.java;104;8;8;0;1;1;0;1
E:\workspace\java\hibernate-orm\hibernate-spatial\src\main\java\org\hibernate\spatial\dialect\mysql\MySQL5SpatialDialect.java;MySQL5SpatialDialect.java;104;2;1;1;1;1;0;1
E:\workspace\java\hibernate-orm\hibernate-core\src\main\java\org\hibernate\internal\JdbcSessionContextImpl.java;JdbcSessionContextImpl.java;104;7;5;2;1;1;0;1
E:\workspace\java\hibernate-orm\hibernate-spatial\src\main\java\org\hibernate\spatial\dialect\oracle\OracleSpatialSDO10gDialect.java;OracleSpatialSDO10gDialect.java;104;6;3;3;1;1;0;1
E:\workspace\java\hibernate-orm\hibernate-core\src\main\java\org\hibernate\mapping\Set.java;Set.java;104;26;19;7;2;3;0;3
E:\workspace\java\hibernate-orm\hibernate-core\src\main\java\org\hibernate\metamodel\model\domain\NavigableRole.java;NavigableRole.java;104;104;104;0;1;1;0;1
E:\workspace\java\hibernate-orm\hibernate-core\src\main\java\org\hibernate\boot\spi\XmlMappingBinderAccess.java;XmlMappingBinderAccess.java;104;4;2;2;1;1;0;1
E:\workspace\java\hibernate-orm\hibernate-core\src\main\java\org\hibernate\hql\spi\id\cte\AbstractCteValuesListBulkIdHandler.java;AbstractCteValuesListBulkIdHandler.java;104;8;7;1;1;1;0;1
E:\workspace\java\hibernate-orm\hibernate-core\src\main\java\org\hibernate\boot\internal\ClassLoaderAccessImpl.java;ClassLoaderAccessImpl.java;103;14;13;1;1;1;0;1
E:\workspace\java\hibernate-orm\hibernate-core\src\main\java\org\hibernate\stat\internal\CacheRegionStatisticsImpl.java;CacheRegionStatisticsImpl.java;102;122;112;10;2;3;0;3
E:\workspace\java\hibernate-orm\hibernate-core\src\main\java\org\hibernate\jpa\internal\util\ConfigurationHelper.java;ConfigurationHelper.java;102;22;11;11;1;1;0;1
E:\workspace\java\hibernate-orm\hibernate-core\src\main\java\org\hibernate\cache\spi\CacheTransactionSynchronization.java;CacheTransactionSynchronization.java;102;102;102;0;1;1;0;1
E:\workspace\java\hibernate-orm\hibernate-core\src\main\java\org\hibernate\type\descriptor\sql\TimestampTypeDescriptor.java;TimestampTypeDescriptor.java;102;4;2;2;1;1;1;0
E:\workspace\java\hibernate-orm\hibernate-core\src\main\java\org\hibernate\loader\collection\PaddedBatchingCollectionInitializerBuilder.java;PaddedBatchingCollectionInitializerBuilder.java;102;2;1;1;1;1;0;1
E:\workspace\java\hibernate-orm\hibernate-spatial\src\main\java\org\hibernate\spatial\SpatialDialect.java;SpatialDialect.java;102;20;10;10;2;2;1;1
E:\workspace\java\hibernate-orm\hibernate-core\src\main\java\org\hibernate\type\descriptor\sql\TimeTypeDescriptor.java;TimeTypeDescriptor.java;102;4;2;2;1;1;1;0
E:\workspace\java\hibernate-orm\hibernate-core\src\main\java\org\hibernate\cache\spi\SecondLevelCacheLogger.java;SecondLevelCacheLogger.java;102;120;111;9;3;6;0;6
E:\workspace\java\hibernate-orm\hibernate-core\src\main\java\org\hibernate\stat\QueryStatistics.java;QueryStatistics.java;102;80;72;8;2;3;0;3
E:\workspace\java\hibernate-orm\hibernate-core\src\main\java\org\hibernate\graph\SubGraph.java;SubGraph.java;100;100;100;0;1;1;0;1
E:\workspace\java\hibernate-orm\hibernate-spatial\src\main\java\org\hibernate\spatial\dialect\sqlserver\SqlServer2008SpatialDialect.java;SqlServer2008SpatialDialect.java;100;132;25;107;2;3;0;3
E:\workspace\java\hibernate-orm\hibernate-core\src\main\java\org\hibernate\stat\internal\EntityStatisticsImpl.java;EntityStatisticsImpl.java;100;140;120;20;2;2;0;2
E:\workspace\java\hibernate-orm\hibernate-core\src\main\java\org\hibernate\type\MapType.java;MapType.java;100;10;9;1;1;1;0;1
E:\workspace\java\hibernate-orm\hibernate-core\src\main\java\org\hibernate\query\internal\QueryParameterBindingImpl.java;QueryParameterBindingImpl.java;100;2;1;1;1;1;0;1
E:\workspace\java\hibernate-orm\hibernate-core\src\main\java\org\hibernate\proxy\ProxyConfiguration.java;ProxyConfiguration.java;99;2;1;1;1;1;1;0
E:\workspace\java\hibernate-orm\hibernate-core\src\main\java\org\hibernate\sql\ordering\antlr\OrderByFragmentTranslator.java;OrderByFragmentTranslator.java;99;8;4;4;1;3;0;3
E:\workspace\java\hibernate-orm\hibernate-core\src\main\java\org\hibernate\metamodel\model\domain\internal\EntityTypeImpl.java;EntityTypeImpl.java;98;108;103;5;1;2;0;2
E:\workspace\java\hibernate-orm\hibernate-core\src\main\java\org\hibernate\metamodel\model\convert\internal\NamedEnumValueConverter.java;NamedEnumValueConverter.java;98;76;36;40;2;2;0;2
E:\workspace\java\hibernate-orm\hibernate-core\src\main\java\org\hibernate\boot\archive\scan\spi\ClassFileArchiveEntryHandler.java;ClassFileArchiveEntryHandler.java;98;2;1;1;1;1;0;1
E:\workspace\java\hibernate-orm\hibernate-core\src\main\java\org\hibernate\tool\schema\SourceType.java;SourceType.java;98;6;3;3;1;1;0;1
E:\workspace\java\hibernate-orm\hibernate-core\src\main\java\org\hibernate\criterion\InExpression.java;InExpression.java;98;4;2;2;1;1;0;1
E:\workspace\java\hibernate-orm\hibernate-core\src\main\java\org\hibernate\boot\model\process\internal\ManagedResourcesImpl.java;ManagedResourcesImpl.java;97;7;3;4;1;1;0;1
E:\workspace\java\hibernate-orm\hibernate-core\src\main\java\org\hibernate\proxy\pojo\bytebuddy\ByteBuddyInterceptor.java;ByteBuddyInterceptor.java;97;19;4;15;3;3;0;3
E:\workspace\java\hibernate-orm\hibernate-core\src\main\java\org\hibernate\tuple\entity\BytecodeEnhancementMetadataNonPojoImpl.java;BytecodeEnhancementMetadataNonPojoImpl.java;97;31;31;0;1;2;0;2
E:\workspace\java\hibernate-orm\hibernate-core\src\main\java\org\hibernate\event\internal\EntityCopyObserverFactoryInitiator.java;EntityCopyObserverFactoryInitiator.java;97;105;101;4;2;2;0;2
E:\workspace\java\hibernate-orm\hibernate-core\src\main\java\org\hibernate\boot\jaxb\internal\stax\HbmEventReader.java;HbmEventReader.java;96;12;8;4;2;2;0;2
E:\workspace\java\hibernate-orm\hibernate-core\src\main\java\org\hibernate\tool\hbm2ddl\ManagedProviderConnectionHelper.java;ManagedProviderConnectionHelper.java;96;1;0;1;1;1;0;1
E:\workspace\java\hibernate-orm\hibernate-core\src\main\java\org\hibernate\event\internal\AbstractLockUpgradeEventListener.java;AbstractLockUpgradeEventListener.java;96;4;2;2;1;1;0;1
E:\workspace\java\hibernate-orm\hibernate-core\src\main\java\org\hibernate\service\StandardServiceInitiators.java;StandardServiceInitiators.java;96;8;6;2;2;3;0;3
E:\workspace\java\hibernate-orm\hibernate-core\src\main\java\org\hibernate\internal\util\collections\JoinedIterable.java;JoinedIterable.java;96;5;3;2;2;2;1;1
E:\workspace\java\hibernate-orm\hibernate-envers\src\main\java\org\hibernate\envers\internal\entities\RevisionTypeType.java;RevisionTypeType.java;96;4;2;2;1;1;0;1
E:\workspace\java\hibernate-orm\hibernate-ehcache\src\main\java\org\hibernate\cache\ehcache\internal\HibernateEhcacheUtils.java;HibernateEhcacheUtils.java;96;102;99;3;1;4;0;4
E:\workspace\java\hibernate-orm\hibernate-core\src\main\java\org\hibernate\metamodel\model\convert\internal\OrdinalEnumValueConverter.java;OrdinalEnumValueConverter.java;96;74;35;39;2;2;0;2
E:\workspace\java\hibernate-orm\hibernate-spatial\src\main\java\org\hibernate\spatial\GeolatteGeometryJavaTypeDescriptor.java;GeolatteGeometryJavaTypeDescriptor.java;95;27;17;10;2;4;0;4
E:\workspace\java\hibernate-orm\hibernate-core\src\main\java\org\hibernate\loader\collection\plan\LegacyBatchingCollectionInitializerBuilder.java;LegacyBatchingCollectionInitializerBuilder.java;95;14;9;5;1;1;0;1
E:\workspace\java\hibernate-orm\hibernate-core\src\main\java\org\hibernate\cache\internal\CacheKeyImplementation.java;CacheKeyImplementation.java;94;10;5;5;3;3;0;3
E:\workspace\java\hibernate-orm\hibernate-core\src\main\java\org\hibernate\event\service\spi\EventListenerGroup.java;EventListenerGroup.java;94;37;37;0;1;2;0;2
E:\workspace\java\hibernate-orm\hibernate-core\src\main\java\org\hibernate\cache\spi\support\CollectionReadWriteAccess.java;CollectionReadWriteAccess.java;94;10;8;2;1;1;0;1
E:\workspace\java\hibernate-orm\hibernate-spatial\src\main\java\org\hibernate\spatial\dialect\hana\HANAGeometryTypeDescriptor.java;HANAGeometryTypeDescriptor.java;94;7;3;4;1;1;0;1
E:\workspace\java\hibernate-orm\hibernate-core\src\main\java\org\hibernate\event\internal\DefaultAutoFlushEventListener.java;DefaultAutoFlushEventListener.java;94;40;24;16;3;4;0;4
E:\workspace\java\hibernate-orm\hibernate-core\src\main\java\org\hibernate\event\internal\EvictVisitor.java;EvictVisitor.java;94;41;28;13;3;3;0;3
E:\workspace\java\hibernate-orm\hibernate-core\src\main\java\org\hibernate\mapping\PrimaryKey.java;PrimaryKey.java;94;2;1;1;1;1;0;1
E:\workspace\java\hibernate-orm\hibernate-envers\src\main\java\org\hibernate\envers\internal\tools\EntityTools.java;EntityTools.java;93;5;3;2;1;1;0;1
E:\workspace\java\hibernate-orm\hibernate-core\src\main\java\org\hibernate\query\criteria\internal\expression\CompoundSelectionImpl.java;CompoundSelectionImpl.java;93;10;4;6;2;2;0;2
E:\workspace\java\hibernate-orm\hibernate-core\src\main\java\org\hibernate\tool\schema\internal\exec\GenerationTargetToDatabase.java;GenerationTargetToDatabase.java;93;4;2;2;1;2;0;2
E:\workspace\java\hibernate-orm\hibernate-core\src\main\java\org\hibernate\type\descriptor\java\EnumJavaTypeDescriptor.java;EnumJavaTypeDescriptor.java;93;7;3;4;2;3;1;2
E:\workspace\java\hibernate-orm\hibernate-spatial\src\main\java\org\hibernate\spatial\dialect\oracle\SDOGeometryValueBinder.java;SDOGeometryValueBinder.java;92;4;2;2;1;1;0;1
E:\workspace\java\hibernate-orm\hibernate-core\src\main\java\org\hibernate\tool\schema\internal\IndividuallySchemaMigratorImpl.java;IndividuallySchemaMigratorImpl.java;92;4;2;2;1;1;1;0
E:\workspace\java\hibernate-orm\hibernate-core\src\main\java\org\hibernate\cache\internal\NoCachingRegionFactory.java;NoCachingRegionFactory.java;92;44;22;22;1;2;0;2
E:\workspace\java\hibernate-orm\hibernate-core\src\main\java\org\hibernate\metamodel\model\domain\internal\AbstractPluralAttribute.java;AbstractPluralAttribute.java;92;110;101;9;1;2;0;2
E:\workspace\java\hibernate-orm\hibernate-core\src\main\java\org\hibernate\tool\schema\internal\GroupedSchemaMigratorImpl.java;GroupedSchemaMigratorImpl.java;92;4;2;2;1;1;1;0
E:\workspace\java\hibernate-orm\hibernate-core\src\main\java\org\hibernate\stat\internal\CollectionStatisticsImpl.java;CollectionStatisticsImpl.java;91;125;108;17;2;2;0;2
E:\workspace\java\hibernate-orm\hibernate-core\src\main\java\org\hibernate\event\internal\AbstractReassociateEventListener.java;AbstractReassociateEventListener.java;91;6;4;2;1;1;0;1
E:\workspace\java\hibernate-orm\hibernate-core\src\main\java\org\hibernate\dialect\MariaDB103Dialect.java;MariaDB103Dialect.java;91;101;96;5;2;4;0;4
E:\workspace\java\hibernate-orm\hibernate-core\src\main\java\org\hibernate\cache\spi\support\AbstractNaturalIdDataAccess.java;AbstractNaturalIdDataAccess.java;91;6;2;4;1;2;0;2
E:\workspace\java\hibernate-orm\hibernate-core\src\main\java\org\hibernate\engine\jdbc\dialect\spi\BasicDialectResolver.java;BasicDialectResolver.java;91;14;9;5;1;2;1;1
E:\workspace\java\hibernate-orm\hibernate-envers\src\main\java\org\hibernate\envers\internal\tools\Tools.java;Tools.java;91;11;0;11;1;1;0;1
E:\workspace\java\hibernate-orm\hibernate-ehcache\src\main\java\org\hibernate\cache\ehcache\internal\SingletonEhcacheRegionFactory.java;SingletonEhcacheRegionFactory.java;90;100;95;5;1;3;0;3
E:\workspace\java\hibernate-orm\hibernate-core\src\main\java\org\hibernate\tool\schema\extract\spi\ExtractionContext.java;ExtractionContext.java;90;42;42;0;1;1;0;1
E:\workspace\java\hibernate-orm\hibernate-spatial\src\main\java\org\hibernate\spatial\dialect\h2geodb\GeoDBGeometryTypeDescriptor.java;GeoDBGeometryTypeDescriptor.java;90;4;2;2;1;1;0;1
E:\workspace\java\hibernate-orm\hibernate-spatial\src\main\java\org\hibernate\spatial\JTSGeometryJavaTypeDescriptor.java;JTSGeometryJavaTypeDescriptor.java;90;21;10;11;2;3;0;3
E:\workspace\java\hibernate-orm\hibernate-core\src\main\java\org\hibernate\bytecode\spi\BytecodeEnhancementMetadata.java;BytecodeEnhancementMetadata.java;90;26;26;0;1;2;0;2
E:\workspace\java\hibernate-orm\hibernate-core\src\main\java\org\hibernate\dialect\DB297Dialect.java;DB297Dialect.java;89;49;39;10;1;2;1;1
E:\workspace\java\hibernate-orm\hibernate-jipijapa\src\main\java\org\jboss\as\jpa\hibernate5\VirtualFileSystemArchiveDescriptor.java;VirtualFileSystemArchiveDescriptor.java;89;197;143;54;1;2;0;2
E:\workspace\java\hibernate-orm\hibernate-core\src\main\java\org\hibernate\param\DynamicFilterParameterSpecification.java;DynamicFilterParameterSpecification.java;88;9;7;2;1;1;0;1
E:\workspace\java\hibernate-orm\hibernate-envers\src\main\java\org\hibernate\envers\query\internal\impl\EntitiesModifiedAtRevisionQuery.java;EntitiesModifiedAtRevisionQuery.java;88;8;8;0;1;1;1;0
E:\workspace\java\hibernate-orm\hibernate-core\src\main\java\org\hibernate\boot\SchemaAutoTooling.java;SchemaAutoTooling.java;88;29;24;5;2;2;0;2
E:\workspace\java\hibernate-orm\hibernate-core\src\main\java\org\hibernate\stat\internal\StatsNamedContainer.java;StatsNamedContainer.java;88;88;88;0;1;1;1;0
E:\workspace\java\hibernate-orm\hibernate-core\src\main\java\org\hibernate\internal\JdbcObserverImpl.java;JdbcObserverImpl.java;88;48;20;28;1;3;0;3
E:\workspace\java\hibernate-orm\hibernate-core\src\main\java\org\hibernate\jpa\HibernateEntityManagerFactory.java;HibernateEntityManagerFactory.java;87;17;17;0;1;1;1;0
E:\workspace\java\hibernate-orm\hibernate-core\src\main\java\org\hibernate\mapping\Array.java;Array.java;87;15;12;3;1;2;0;2
E:\workspace\java\hibernate-orm\hibernate-core\src\main\java\org\hibernate\tool\schema\internal\exec\ScriptSourceInputFromUrl.java;ScriptSourceInputFromUrl.java;87;5;5;0;1;1;0;1
E:\workspace\java\hibernate-orm\hibernate-spatial\src\main\java\org\hibernate\spatial\dialect\hana\HANAPointTypeDescriptor.java;HANAPointTypeDescriptor.java;86;6;3;3;1;1;0;1
E:\workspace\java\hibernate-orm\hibernate-core\src\main\java\org\hibernate\cache\spi\support\EntityNonStrictReadWriteAccess.java;EntityNonStrictReadWriteAccess.java;86;11;8;3;1;2;0;2
E:\workspace\java\hibernate-orm\hibernate-core\src\main\java\org\hibernate\engine\query\spi\sql\NativeSQLQuerySpecification.java;NativeSQLQuerySpecification.java;86;3;1;2;1;1;0;1
E:\workspace\java\hibernate-orm\hibernate-core\src\main\java\org\hibernate\loader\collection\LegacyBatchingCollectionInitializerBuilder.java;LegacyBatchingCollectionInitializerBuilder.java;86;2;1;1;1;1;0;1
E:\workspace\java\hibernate-orm\hibernate-core\src\main\java\org\hibernate\dialect\SQLServer2012Dialect.java;SQLServer2012Dialect.java;86;10;4;6;3;4;0;4
E:\workspace\java\hibernate-orm\hibernate-spatial\src\main\java\org\hibernate\spatial\dialect\sqlserver\SqlServer2012SpatialDialect.java;SqlServer2012SpatialDialect.java;86;86;86;0;1;2;1;1
E:\workspace\java\hibernate-orm\hibernate-spatial\src\main\java\org\hibernate\spatial\dialect\oracle\SDOObjectMethod.java;SDOObjectMethod.java;86;26;13;13;1;1;0;1
E:\workspace\java\hibernate-orm\hibernate-core\src\main\java\org\hibernate\event\internal\ProxyVisitor.java;ProxyVisitor.java;85;11;6;5;1;1;0;1
E:\workspace\java\hibernate-orm\hibernate-envers\src\main\java\org\hibernate\envers\strategy\AuditStrategy.java;AuditStrategy.java;85;187;35;152;1;2;0;2
E:\workspace\java\hibernate-orm\hibernate-core\src\main\java\org\hibernate\boot\xsd\MappingXsdSupport.java;MappingXsdSupport.java;85;85;85;0;2;2;0;2
E:\workspace\java\hibernate-orm\hibernate-core\src\main\java\org\hibernate\hql\internal\ast\DetailedSemanticException.java;DetailedSemanticException.java;85;4;4;0;1;1;0;1
E:\workspace\java\hibernate-orm\hibernate-core\src\main\java\org\hibernate\type\descriptor\java\DurationJavaDescriptor.java;DurationJavaDescriptor.java;85;2;1;1;1;1;0;1
E:\workspace\java\hibernate-orm\hibernate-core\src\main\java\org\hibernate\sql\InsertSelect.java;InsertSelect.java;85;12;6;6;1;3;1;2
E:\workspace\java\hibernate-orm\hibernate-core\src\main\java\org\hibernate\hql\internal\ast\tree\Node.java;Node.java;85;2;1;1;1;1;0;1
E:\workspace\java\hibernate-orm\hibernate-core\src\main\java\org\hibernate\engine\internal\BatchFetchQueueHelper.java;BatchFetchQueueHelper.java;85;7;3;4;2;3;1;2
E:\workspace\java\hibernate-orm\hibernate-core\src\main\java\org\hibernate\jpa\event\internal\EmptyCallbackRegistryImpl.java;EmptyCallbackRegistryImpl.java;84;84;84;0;1;1;0;1
E:\workspace\java\hibernate-orm\hibernate-core\src\main\java\org\hibernate\proxy\AbstractSerializableProxy.java;AbstractSerializableProxy.java;84;37;34;3;1;3;0;3
E:\workspace\java\hibernate-orm\hibernate-core\src\main\java\org\hibernate\action\internal\CollectionRecreateAction.java;CollectionRecreateAction.java;84;11;7;4;1;1;0;1
E:\workspace\java\hibernate-orm\hibernate-core\src\main\java\org\hibernate\cfg\CollectionSecondPass.java;CollectionSecondPass.java;83;5;2;3;1;1;0;1
E:\workspace\java\hibernate-orm\tooling\hibernate-gradle-plugin\src\main\groovy\org\hibernate\orm\tooling\gradle\HibernatePlugin.java;HibernatePlugin.java;83;180;20;160;2;2;0;2
E:\workspace\java\hibernate-orm\hibernate-core\src\main\java\org\hibernate\dialect\MySQL57Dialect.java;MySQL57Dialect.java;83;7;7;0;1;1;0;1
E:\workspace\java\hibernate-orm\hibernate-core\src\main\java\org\hibernate\mapping\Formula.java;Formula.java;83;19;13;6;4;4;0;4
E:\workspace\java\hibernate-orm\tooling\metamodel-generator\src\main\java\org\hibernate\jpamodelgen\util\Constants.java;Constants.java;83;3;3;0;1;1;0;1
E:\workspace\java\hibernate-orm\hibernate-core\src\main\java\org\hibernate\hql\internal\ast\tree\SelectExpressionList.java;SelectExpressionList.java;83;3;2;1;1;1;0;1
E:\workspace\java\hibernate-orm\hibernate-core\src\main\java\org\hibernate\persister\entity\NamedQueryLoader.java;NamedQueryLoader.java;83;2;1;1;1;1;0;1
E:\workspace\java\hibernate-orm\hibernate-core\src\main\java\org\hibernate\internal\util\collections\StandardStack.java;StandardStack.java;83;83;83;0;1;1;0;1
E:\workspace\java\hibernate-orm\hibernate-core\src\main\java\org\hibernate\graph\spi\AttributeNodeImplementor.java;AttributeNodeImplementor.java;83;85;75;10;1;2;0;2
E:\workspace\java\hibernate-orm\hibernate-core\src\main\java\org\hibernate\dialect\pagination\SybaseASE157LimitHandler.java;SybaseASE157LimitHandler.java;83;83;83;0;1;1;0;1
E:\workspace\java\hibernate-orm\hibernate-core\src\main\java\org\hibernate\boot\registry\classloading\spi\ClassLoaderService.java;ClassLoaderService.java;83;10;5;5;1;1;0;1
E:\workspace\java\hibernate-orm\hibernate-core\src\main\java\org\hibernate\cache\spi\support\EntityReadOnlyAccess.java;EntityReadOnlyAccess.java;83;8;7;1;1;2;0;2
E:\workspace\java\hibernate-orm\hibernate-spatial\src\main\java\org\hibernate\spatial\dialect\oracle\criterion\RelationshipMask.java;RelationshipMask.java;82;1;1;0;1;1;0;1
E:\workspace\java\hibernate-orm\hibernate-spatial\src\main\java\org\hibernate\spatial\dialect\oracle\SDOGeometryValueExtractor.java;SDOGeometryValueExtractor.java;82;11;5;6;1;1;0;1
E:\workspace\java\hibernate-orm\hibernate-core\src\main\java\org\hibernate\engine\spi\PersistentAttributeInterceptor.java;PersistentAttributeInterceptor.java;81;65;47;18;1;1;0;1
E:\workspace\java\hibernate-orm\hibernate-spatial\src\main\java\org\hibernate\spatial\dialect\oracle\SDOObjectProperty.java;SDOObjectProperty.java;81;26;13;13;1;1;0;1
E:\workspace\java\hibernate-orm\hibernate-core\src\main\java\org\hibernate\cache\spi\UpdateTimestampsCache.java;UpdateTimestampsCache.java;81;172;17;155;1;2;0;2
E:\workspace\java\hibernate-orm\hibernate-core\src\main\java\org\hibernate\cache\spi\QueryCache.java;QueryCache.java;81;31;13;18;1;2;0;2
E:\workspace\java\hibernate-orm\hibernate-core\src\main\java\org\hibernate\bytecode\internal\bytebuddy\BasicProxyFactoryImpl.java;BasicProxyFactoryImpl.java;81;154;73;81;2;15;0;15
E:\workspace\java\hibernate-orm\hibernate-envers\src\main\java\org\hibernate\envers\boot\internal\EnversService.java;EnversService.java;80;8;4;4;1;2;0;2
E:\workspace\java\hibernate-orm\hibernate-core\src\main\java\org\hibernate\IdentifierLoadAccess.java;IdentifierLoadAccess.java;80;9;9;0;1;1;0;1
E:\workspace\java\hibernate-orm\hibernate-core\src\main\java\org\hibernate\query\criteria\internal\expression\ParameterExpressionImpl.java;ParameterExpressionImpl.java;80;9;5;4;2;2;0;2
E:\workspace\java\hibernate-orm\hibernate-core\src\main\java\org\hibernate\type\ShortType.java;ShortType.java;80;4;2;2;1;1;0;1
E:\workspace\java\hibernate-orm\hibernate-osgi\src\main\java\org\hibernate\osgi\OsgiPersistenceProviderService.java;OsgiPersistenceProviderService.java;79;12;11;1;1;1;0;1
E:\workspace\java\hibernate-orm\hibernate-core\src\main\java\org\hibernate\sql\ordering\antlr\OrderByFragmentRenderer.java;OrderByFragmentRenderer.java;79;4;2;2;1;1;0;1
E:\workspace\java\hibernate-orm\hibernate-core\src\main\java\org\hibernate\mapping\IdentifierCollection.java;IdentifierCollection.java;79;32;23;9;2;3;1;2
E:\workspace\java\hibernate-orm\hibernate-spatial\src\main\java\org\hibernate\spatial\criterion\SpatialFilter.java;SpatialFilter.java;79;10;5;5;1;2;0;2
E:\workspace\java\hibernate-orm\hibernate-core\src\main\java\org\hibernate\query\criteria\internal\expression\CoalesceExpression.java;CoalesceExpression.java;79;4;0;4;1;1;0;1
E:\workspace\java\hibernate-orm\hibernate-core\src\main\java\org\hibernate\boot\model\source\internal\hbm\TableSourceImpl.java;TableSourceImpl.java;78;4;2;2;1;1;0;1
E:\workspace\java\hibernate-orm\hibernate-core\src\main\java\org\hibernate\graph\internal\SubGraphImpl.java;SubGraphImpl.java;78;90;84;6;2;3;0;3
E:\workspace\java\hibernate-orm\hibernate-core\src\main\java\org\hibernate\criterion\IdentifierProjection.java;IdentifierProjection.java;78;3;1;2;1;1;0;1
E:\workspace\java\hibernate-orm\hibernate-core\src\main\java\org\hibernate\mapping\DependantValue.java;DependantValue.java;77;27;24;3;2;3;1;2
E:\workspace\java\hibernate-orm\hibernate-core\src\main\java\org\hibernate\query\criteria\internal\compile\RenderingContext.java;RenderingContext.java;77;9;8;1;2;2;0;2
E:\workspace\java\hibernate-orm\hibernate-core\src\main\java\org\hibernate\mapping\UniqueKey.java;UniqueKey.java;77;2;1;1;1;1;0;1
E:\workspace\java\hibernate-orm\hibernate-core\src\main\java\org\hibernate\jpa\internal\util\LockOptionsHelper.java;LockOptionsHelper.java;77;77;77;0;1;1;0;1
E:\workspace\java\hibernate-orm\hibernate-envers\src\main\java\org\hibernate\envers\internal\entities\mapper\PropertyMapper.java;PropertyMapper.java;77;2;1;1;1;1;0;1
E:\workspace\java\hibernate-orm\hibernate-core\src\main\java\org\hibernate\bytecode\enhance\internal\javassist\CompositeEnhancer.java;CompositeEnhancer.java;77;3;1;2;1;1;0;1
E:\workspace\java\hibernate-orm\hibernate-core\src\main\java\org\hibernate\engine\transaction\jta\platform\internal\WebSphereLibertyJtaPlatform.java;WebSphereLibertyJtaPlatform.java;77;77;77;0;1;1;0;1
E:\workspace\java\hibernate-orm\hibernate-core\src\main\java\org\hibernate\internal\SessionCreationOptions.java;SessionCreationOptions.java;77;10;9;1;1;2;0;2
E:\workspace\java\hibernate-orm\hibernate-core\src\main\java\org\hibernate\tool\schema\JdbcMetadaAccessStrategy.java;JdbcMetadaAccessStrategy.java;77;43;30;13;2;2;0;2
E:\workspace\java\hibernate-orm\hibernate-core\src\main\java\org\hibernate\cache\spi\support\RegionFactoryTemplate.java;RegionFactoryTemplate.java;77;77;77;0;1;1;0;1
E:\workspace\java\hibernate-orm\hibernate-core\src\main\java\org\hibernate\criterion\PropertyProjection.java;PropertyProjection.java;76;3;1;2;1;1;0;1
E:\workspace\java\hibernate-orm\hibernate-core\src\main\java\org\hibernate\stat\CacheRegionStatistics.java;CacheRegionStatistics.java;76;84;80;4;1;2;0;2
E:\workspace\java\hibernate-orm\hibernate-core\src\main\java\org\hibernate\boot\model\TypeContributions.java;TypeContributions.java;76;82;66;16;1;3;0;3
E:\workspace\java\hibernate-orm\hibernate-core\src\main\java\org\hibernate\event\internal\DefaultPostLoadEventListener.java;DefaultPostLoadEventListener.java;76;30;22;8;3;3;0;3
E:\workspace\java\hibernate-orm\hibernate-core\src\main\java\org\hibernate\usertype\UserCollectionType.java;UserCollectionType.java;75;94;47;47;1;2;0;2
E:\workspace\java\hibernate-orm\hibernate-core\src\main\java\org\hibernate\resource\transaction\spi\TransactionStatus.java;TransactionStatus.java;75;4;4;0;1;1;0;1
E:\workspace\java\hibernate-orm\hibernate-core\src\main\java\org\hibernate\boot\jaxb\Origin.java;Origin.java;75;4;2;2;1;1;0;1
E:\workspace\java\hibernate-orm\hibernate-spatial\src\main\java\org\hibernate\spatial\criterion\DWithinExpression.java;DWithinExpression.java;74;16;9;7;1;2;0;2
E:\workspace\java\hibernate-orm\hibernate-spatial\src\main\java\org\hibernate\spatial\criterion\SpatialRelateExpression.java;SpatialRelateExpression.java;74;6;3;3;1;2;0;2
E:\workspace\java\hibernate-orm\hibernate-core\src\main\java\org\hibernate\hql\internal\ast\tree\ResultVariableRefNode.java;ResultVariableRefNode.java;73;3;1;2;1;1;0;1
E:\workspace\java\hibernate-orm\hibernate-core\src\main\java\org\hibernate\internal\log\ConnectionPoolingLogger.java;ConnectionPoolingLogger.java;73;2;1;1;1;1;0;1
E:\workspace\java\hibernate-orm\hibernate-core\src\main\java\org\hibernate\TransientPropertyValueException.java;TransientPropertyValueException.java;73;2;1;1;1;1;1;0
E:\workspace\java\hibernate-orm\hibernate-core\src\main\java\org\hibernate\query\criteria\internal\expression\SubqueryComparisonModifierExpression.java;SubqueryComparisonModifierExpression.java;73;4;0;4;1;1;0;1
E:\workspace\java\hibernate-orm\hibernate-spatial\src\main\java\org\hibernate\spatial\criterion\ExpressionUtil.java;ExpressionUtil.java;73;4;3;1;1;1;0;1
E:\workspace\java\hibernate-orm\hibernate-core\src\main\java\org\hibernate\engine\jdbc\batch\internal\BatchBuilderImpl.java;BatchBuilderImpl.java;73;17;0;17;1;1;0;1
E:\workspace\java\hibernate-orm\hibernate-core\src\main\java\org\hibernate\service\internal\SessionFactoryServiceRegistryBuilderImpl.java;SessionFactoryServiceRegistryBuilderImpl.java;73;19;4;15;2;3;0;3
E:\workspace\java\hibernate-orm\hibernate-core\src\main\java\org\hibernate\boot\internal\MetadataBuildingContextRootImpl.java;MetadataBuildingContextRootImpl.java;72;24;15;9;1;2;0;2
E:\workspace\java\hibernate-orm\hibernate-core\src\main\java\org\hibernate\query\criteria\internal\predicate\MemberOfPredicate.java;MemberOfPredicate.java;72;2;1;1;1;1;1;0
E:\workspace\java\hibernate-orm\hibernate-core\src\main\java\org\hibernate\hql\internal\ast\util\ASTReferencedTablesPrinter.java;ASTReferencedTablesPrinter.java;72;72;72;0;1;1;0;1
E:\workspace\java\hibernate-orm\hibernate-core\src\main\java\org\hibernate\id\insert\AbstractReturningDelegate.java;AbstractReturningDelegate.java;72;8;5;3;1;1;0;1
E:\workspace\java\hibernate-orm\hibernate-core\src\main\java\org\hibernate\metamodel\model\domain\spi\DomainModelHelper.java;DomainModelHelper.java;72;88;80;8;1;3;0;3
E:\workspace\java\hibernate-orm\hibernate-core\src\main\java\org\hibernate\query\criteria\internal\expression\ConcatExpression.java;ConcatExpression.java;71;4;0;4;1;1;0;1
E:\workspace\java\hibernate-orm\hibernate-core\src\main\java\org\hibernate\type\descriptor\sql\SqlTypeDescriptor.java;SqlTypeDescriptor.java;71;19;15;4;1;2;0;2
E:\workspace\java\hibernate-orm\hibernate-core\src\main\java\org\hibernate\id\IdentifierGenerator.java;IdentifierGenerator.java;71;10;9;1;1;1;0;1
E:\workspace\java\hibernate-orm\hibernate-core\src\main\java\org\hibernate\cache\cfg\internal\EntityDataCachingConfigImpl.java;EntityDataCachingConfigImpl.java;71;71;71;0;1;1;0;1
E:\workspace\java\hibernate-orm\hibernate-core\src\main\java\org\hibernate\engine\transaction\jta\platform\spi\JtaPlatform.java;JtaPlatform.java;71;15;7;8;2;2;0;2
E:\workspace\java\hibernate-orm\hibernate-core\src\main\java\org\hibernate\type\SingleColumnType.java;SingleColumnType.java;71;122;61;61;1;2;0;2
E:\workspace\java\hibernate-orm\hibernate-core\src\main\java\org\hibernate\event\internal\OnReplicateVisitor.java;OnReplicateVisitor.java;71;2;1;1;1;1;0;1
E:\workspace\java\hibernate-orm\hibernate-spatial\src\main\java\org\hibernate\spatial\dialect\oracle\SpatialAggregate.java;SpatialAggregate.java;71;4;1;3;1;1;0;1
E:\workspace\java\hibernate-orm\hibernate-core\src\main\java\org\hibernate\event\service\internal\PostCommitEventListenerGroupImpl.java;PostCommitEventListenerGroupImpl.java;71;6;3;3;1;1;0;1
E:\workspace\java\hibernate-orm\hibernate-core\src\main\java\org\hibernate\boot\model\process\spi\NoOpMetadataSourceProcessorImpl.java;NoOpMetadataSourceProcessorImpl.java;71;71;71;0;1;1;0;1
E:\workspace\java\hibernate-orm\hibernate-core\src\main\java\org\hibernate\query\criteria\internal\expression\NullifExpression.java;NullifExpression.java;70;4;0;4;1;1;0;1
E:\workspace\java\hibernate-orm\hibernate-spatial\src\main\java\org\hibernate\spatial\criterion\SpatialProjections.java;SpatialProjections.java;70;2;1;1;1;1;0;1
E:\workspace\java\hibernate-orm\hibernate-core\src\main\java\org\hibernate\resource\jdbc\spi\JdbcSessionOwner.java;JdbcSessionOwner.java;70;8;8;0;1;1;0;1
E:\workspace\java\hibernate-orm\hibernate-jcache\src\main\java\org\hibernate\cache\jcache\internal\JCacheAccessImpl.java;JCacheAccessImpl.java;70;88;79;9;1;3;0;3
E:\workspace\java\hibernate-orm\hibernate-core\src\main\java\org\hibernate\engine\jdbc\dialect\internal\DialectResolverInitiator.java;DialectResolverInitiator.java;70;2;1;1;1;1;0;1
E:\workspace\java\hibernate-orm\hibernate-core\src\main\java\org\hibernate\engine\transaction\jta\platform\internal\JBossStandAloneJtaPlatform.java;JBossStandAloneJtaPlatform.java;70;77;48;29;2;4;0;4
E:\workspace\java\hibernate-orm\hibernate-core\src\main\java\org\hibernate\cache\spi\entry\StructuredCacheEntry.java;StructuredCacheEntry.java;70;15;6;9;2;2;0;2
E:\workspace\java\hibernate-orm\hibernate-envers\src\main\java\org\hibernate\envers\internal\tools\Triple.java;Triple.java;70;8;4;4;1;1;0;1
E:\workspace\java\hibernate-orm\hibernate-core\src\main\java\org\hibernate\query\internal\QueryImpl.java;QueryImpl.java;70;82;41;41;1;2;0;2
E:\workspace\java\hibernate-orm\hibernate-core\src\main\java\org\hibernate\resource\transaction\spi\TransactionCoordinatorOwner.java;TransactionCoordinatorOwner.java;69;10;10;0;1;1;0;1
E:\workspace\java\hibernate-orm\hibernate-core\src\main\java\org\hibernate\InvalidMappingException.java;InvalidMappingException.java;69;63;0;63;1;1;0;1
E:\workspace\java\hibernate-orm\hibernate-core\src\main\java\org\hibernate\internal\util\xml\XMLHelper.java;XMLHelper.java;69;44;28;16;1;1;0;1
E:\workspace\java\hibernate-orm\hibernate-core\src\main\java\org\hibernate\procedure\spi\ParameterRegistrationImplementor.java;ParameterRegistrationImplementor.java;69;2;2;0;1;2;0;2
E:\workspace\java\hibernate-orm\hibernate-core\src\main\java\org\hibernate\persister\walking\spi\AssociationKey.java;AssociationKey.java;69;3;1;2;1;1;0;1
E:\workspace\java\hibernate-orm\hibernate-core\src\main\java\org\hibernate\loader\plan\exec\process\internal\EntityReturnReader.java;EntityReturnReader.java;68;2;1;1;1;1;0;1
E:\workspace\java\hibernate-orm\hibernate-core\src\main\java\org\hibernate\dialect\MySQL5Dialect.java;MySQL5Dialect.java;68;7;6;1;2;2;0;2
E:\workspace\java\hibernate-orm\hibernate-core\src\main\java\org\hibernate\id\SequenceMismatchStrategy.java;SequenceMismatchStrategy.java;68;68;68;0;1;1;0;1
E:\workspace\java\hibernate-orm\hibernate-core\src\main\java\org\hibernate\bytecode\internal\bytebuddy\PassThroughInterceptor.java;PassThroughInterceptor.java;68;53;27;26;1;1;0;1
E:\workspace\java\hibernate-orm\hibernate-core\src\main\java\org\hibernate\query\criteria\internal\expression\MapEntryExpression.java;MapEntryExpression.java;67;55;29;26;2;2;0;2
E:\workspace\java\hibernate-orm\hibernate-core\src\main\java\org\hibernate\PropertyAccessException.java;PropertyAccessException.java;67;4;2;2;1;1;0;1
E:\workspace\java\hibernate-orm\hibernate-core\src\main\java\org\hibernate\cache\spi\DomainDataRegion.java;DomainDataRegion.java;67;69;68;1;1;3;0;3
E:\workspace\java\hibernate-orm\hibernate-core\src\main\java\org\hibernate\dialect\HANAColumnStoreDialect.java;HANAColumnStoreDialect.java;67;23;21;2;1;2;0;2
E:\workspace\java\hibernate-orm\hibernate-jcache\src\main\java\org\hibernate\cache\jcache\internal\JCacheDomainDataRegionImpl.java;JCacheDomainDataRegionImpl.java;67;67;67;0;1;1;0;1
E:\workspace\java\hibernate-orm\hibernate-core\src\main\java\org\hibernate\event\internal\DirtyCollectionSearchVisitor.java;DirtyCollectionSearchVisitor.java;67;2;1;1;1;1;0;1
E:\workspace\java\hibernate-orm\hibernate-core\src\main\java\org\hibernate\metamodel\model\convert\internal\JpaAttributeConverterImpl.java;JpaAttributeConverterImpl.java;67;18;12;6;1;1;0;1
E:\workspace\java\hibernate-orm\hibernate-spatial\src\main\java\org\hibernate\spatial\dialect\sqlserver\SqlServerFunctions.java;SqlServerFunctions.java;66;66;66;0;1;2;1;1
E:\workspace\java\hibernate-orm\hibernate-core\src\main\java\org\hibernate\tuple\entity\PojoEntityInstantiator.java;PojoEntityInstantiator.java;66;1;1;0;1;1;0;1
E:\workspace\java\hibernate-orm\hibernate-core\src\main\java\org\hibernate\criterion\MatchMode.java;MatchMode.java;66;2;1;1;1;1;1;0
E:\workspace\java\hibernate-orm\hibernate-spatial\src\main\java\org\hibernate\spatial\dialect\oracle\SDOGeometryTypeDescriptor.java;SDOGeometryTypeDescriptor.java;66;5;3;2;1;1;0;1
E:\workspace\java\hibernate-orm\hibernate-core\src\main\java\org\hibernate\event\internal\EntityCopyNotAllowedObserver.java;EntityCopyNotAllowedObserver.java;66;10;9;1;1;1;0;1
E:\workspace\java\hibernate-orm\hibernate-jcache\src\main\java\org\hibernate\cache\jcache\MissingCacheStrategy.java;MissingCacheStrategy.java;66;72;69;3;3;4;0;4
E:\workspace\java\hibernate-orm\hibernate-spatial\src\main\java\org\hibernate\spatial\SpatialRelation.java;SpatialRelation.java;66;4;2;2;1;1;0;1
E:\workspace\java\hibernate-orm\hibernate-core\src\main\java\org\hibernate\resource\beans\internal\BeansMessageLogger.java;BeansMessageLogger.java;65;8;8;0;1;1;0;1
E:\workspace\java\hibernate-orm\hibernate-core\src\main\java\org\hibernate\dialect\Oracle12cDialect.java;Oracle12cDialect.java;65;7;0;7;1;1;0;1
E:\workspace\java\hibernate-orm\hibernate-core\src\main\java\org\hibernate\tool\schema\extract\spi\SequenceInformation.java;SequenceInformation.java;65;39;37;2;1;1;0;1
E:\workspace\java\hibernate-orm\hibernate-core\src\main\java\org\hibernate\internal\util\collections\SingletonStack.java;SingletonStack.java;65;65;65;0;1;1;0;1
E:\workspace\java\hibernate-orm\hibernate-core\src\main\java\org\hibernate\mapping\Map.java;Map.java;65;15;12;3;1;2;0;2
E:\workspace\java\hibernate-orm\hibernate-core\src\main\java\org\hibernate\loader\plan\build\internal\LoadGraphLoadPlanBuildingStrategy.java;LoadGraphLoadPlanBuildingStrategy.java;65;24;18;6;1;1;0;1
E:\workspace\java\hibernate-orm\hibernate-core\src\main\java\org\hibernate\internal\util\collections\Stack.java;Stack.java;65;65;65;0;1;1;0;1
E:\workspace\java\hibernate-orm\hibernate-core\src\main\java\org\hibernate\query\internal\QueryParameterNamedImpl.java;QueryParameterNamedImpl.java;64;1;1;0;1;1;0;1
E:\workspace\java\hibernate-orm\hibernate-core\src\main\java\org\hibernate\type\descriptor\spi\JdbcRecommendedSqlTypeMappingContext.java;JdbcRecommendedSqlTypeMappingContext.java;64;64;64;0;1;1;0;1
E:\workspace\java\hibernate-orm\hibernate-ehcache\src\main\java\org\hibernate\cache\ehcache\MissingCacheStrategy.java;MissingCacheStrategy.java;64;70;67;3;2;4;0;4
E:\workspace\java\hibernate-orm\hibernate-core\src\main\java\org\hibernate\dialect\lock\PessimisticForceIncrementLockingStrategy.java;PessimisticForceIncrementLockingStrategy.java;64;2;1;1;1;1;0;1
E:\workspace\java\hibernate-orm\hibernate-core\src\main\java\org\hibernate\cache\cfg\internal\NaturalIdDataCachingConfigImpl.java;NaturalIdDataCachingConfigImpl.java;64;64;64;0;1;1;0;1
E:\workspace\java\hibernate-orm\hibernate-core\src\main\java\org\hibernate\cache\spi\support\StorageAccess.java;StorageAccess.java;64;94;79;15;1;3;0;3
E:\workspace\java\hibernate-orm\hibernate-core\src\main\java\org\hibernate\query\criteria\internal\expression\function\CastFunction.java;CastFunction.java;64;18;13;5;1;1;0;1
E:\workspace\java\hibernate-orm\hibernate-envers\src\main\java\org\hibernate\envers\internal\entities\mapper\relation\CommonCollectionMapperData.java;CommonCollectionMapperData.java;64;15;12;3;1;1;0;1
E:\workspace\java\hibernate-orm\hibernate-core\src\main\java\org\hibernate\type\ListType.java;ListType.java;63;10;9;1;1;1;0;1
E:\workspace\java\hibernate-orm\hibernate-core\src\main\java\org\hibernate\bytecode\spi\BytecodeProvider.java;BytecodeProvider.java;63;12;12;0;1;1;0;1
E:\workspace\java\hibernate-orm\hibernate-core\src\main\java\org\hibernate\dialect\SybaseAnywhereDialect.java;SybaseAnywhereDialect.java;63;18;17;1;1;1;0;1
E:\workspace\java\hibernate-orm\hibernate-core\src\main\java\org\hibernate\type\descriptor\java\spi\RegistryHelper.java;RegistryHelper.java;63;63;63;0;1;1;0;1
E:\workspace\java\hibernate-orm\hibernate-envers\src\main\java\org\hibernate\envers\internal\entities\mapper\id\QueryParameterData.java;QueryParameterData.java;63;5;3;2;1;1;0;1
E:\workspace\java\hibernate-orm\hibernate-core\src\main\java\org\hibernate\type\descriptor\java\spi\JavaTypeDescriptorRegistry.java;JavaTypeDescriptorRegistry.java;62;94;78;16;1;3;0;3
E:\workspace\java\hibernate-orm\hibernate-core\src\main\java\org\hibernate\query\criteria\internal\expression\UnaryArithmeticOperation.java;UnaryArithmeticOperation.java;62;5;0;5;1;1;0;1
E:\workspace\java\hibernate-orm\hibernate-core\src\main\java\org\hibernate\event\internal\FlushVisitor.java;FlushVisitor.java;62;25;12;13;2;2;0;2
E:\workspace\java\hibernate-orm\hibernate-core\src\main\java\org\hibernate\bytecode\spi\ClassLoadingStrategyHelper.java;ClassLoadingStrategyHelper.java;62;62;62;0;1;1;0;1
E:\workspace\java\hibernate-orm\hibernate-core\src\main\java\org\hibernate\graph\GraphSemantic.java;GraphSemantic.java;62;62;62;0;1;1;0;1
E:\workspace\java\hibernate-orm\hibernate-core\src\main\java\org\hibernate\resource\beans\container\internal\CdiBeanContainerImmediateAccessImpl.java;CdiBeanContainerImmediateAccessImpl.java;62;90;76;14;1;3;0;3
E:\workspace\java\hibernate-orm\hibernate-core\src\main\java\org\hibernate\event\internal\DefaultSaveEventListener.java;DefaultSaveEventListener.java;62;2;1;1;1;1;0;1
E:\workspace\java\hibernate-orm\hibernate-core\src\main\java\org\hibernate\action\internal\QueuedOperationCollectionAction.java;QueuedOperationCollectionAction.java;62;19;18;1;2;2;0;2
E:\workspace\java\hibernate-orm\hibernate-core\src\main\java\org\hibernate\context\spi\AbstractCurrentSessionContext.java;AbstractCurrentSessionContext.java;62;5;3;2;1;1;0;1
E:\workspace\java\hibernate-orm\hibernate-core\src\main\java\org\hibernate\metamodel\model\domain\spi\IdentifiableTypeDescriptor.java;IdentifiableTypeDescriptor.java;62;64;63;1;2;2;1;1
E:\workspace\java\hibernate-orm\hibernate-core\src\main\java\org\hibernate\boot\spi\MetadataImplementor.java;MetadataImplementor.java;62;19;19;0;1;3;0;3
E:\workspace\java\hibernate-orm\hibernate-core\src\main\java\org\hibernate\bytecode\enhance\spi\LazyPropertyInitializer.java;LazyPropertyInitializer.java;62;15;13;2;1;1;0;1
E:\workspace\java\hibernate-orm\hibernate-core\src\main\java\org\hibernate\metamodel\model\domain\internal\AbstractType.java;AbstractType.java;61;4;2;2;1;1;0;1
E:\workspace\java\hibernate-orm\hibernate-core\src\main\java\org\hibernate\stat\NaturalIdCacheStatistics.java;NaturalIdCacheStatistics.java;61;62;41;21;1;2;0;2
E:\workspace\java\hibernate-orm\hibernate-core\src\main\java\org\hibernate\engine\query\spi\AbstractParameterDescriptor.java;AbstractParameterDescriptor.java;61;6;5;1;1;2;0;2
E:\workspace\java\hibernate-orm\hibernate-core\src\main\java\org\hibernate\event\internal\DefaultUpdateEventListener.java;DefaultUpdateEventListener.java;61;2;1;1;1;1;0;1
E:\workspace\java\hibernate-orm\hibernate-core\src\main\java\org\hibernate\service\ServiceRegistry.java;ServiceRegistry.java;61;4;3;1;1;1;0;1
E:\workspace\java\hibernate-orm\hibernate-core\src\main\java\org\hibernate\cache\spi\support\NaturalIdNonStrictReadWriteAccess.java;NaturalIdNonStrictReadWriteAccess.java;61;12;9;3;1;2;0;2
E:\workspace\java\hibernate-orm\hibernate-envers\src\main\java\org\hibernate\envers\internal\entities\mapper\relation\lazy\initializor\AbstractCollectionInitializor.java;AbstractCollectionInitializor.java;61;4;3;1;1;1;1;0
E:\workspace\java\hibernate-orm\hibernate-core\src\main\java\org\hibernate\graph\internal\parse\PathQualifierType.java;PathQualifierType.java;61;73;67;6;1;2;0;2
E:\workspace\java\hibernate-orm\hibernate-core\src\main\java\org\hibernate\boot\archive\internal\JarProtocolArchiveDescriptor.java;JarProtocolArchiveDescriptor.java;61;2;1;1;1;1;0;1
E:\workspace\java\hibernate-orm\hibernate-core\src\main\java\org\hibernate\type\descriptor\sql\NationalizedTypeMappings.java;NationalizedTypeMappings.java;60;58;32;26;1;3;0;3
E:\workspace\java\hibernate-orm\hibernate-core\src\main\java\org\hibernate\type\internal\TypeConfigurationRegistry.java;TypeConfigurationRegistry.java;60;60;60;0;1;1;0;1
E:\workspace\java\hibernate-orm\hibernate-core\src\main\java\org\hibernate\criterion\PropertyExpression.java;PropertyExpression.java;60;2;1;1;1;1;0;1
E:\workspace\java\hibernate-orm\hibernate-core\src\main\java\org\hibernate\procedure\ProcedureCallMemento.java;ProcedureCallMemento.java;60;24;24;0;1;1;0;1
E:\workspace\java\hibernate-orm\hibernate-core\src\main\java\org\hibernate\persister\entity\MultiLoadOptions.java;MultiLoadOptions.java;60;36;36;0;1;1;0;1
E:\workspace\java\hibernate-orm\hibernate-core\src\main\java\org\hibernate\tool\schema\extract\internal\SequenceInformationImpl.java;SequenceInformationImpl.java;60;35;30;5;1;1;0;1
E:\workspace\java\hibernate-orm\hibernate-core\src\main\java\org\hibernate\internal\NonContextualJdbcConnectionAccess.java;NonContextualJdbcConnectionAccess.java;60;3;3;0;1;1;0;1
E:\workspace\java\hibernate-orm\hibernate-spatial\src\main\java\org\hibernate\spatial\GeolatteGeometryType.java;GeolatteGeometryType.java;60;32;17;15;2;2;0;2
E:\workspace\java\hibernate-orm\hibernate-core\src\main\java\org\hibernate\boot\spi\MetadataBuildingContext.java;MetadataBuildingContext.java;60;24;14;10;1;2;0;2
E:\workspace\java\hibernate-orm\hibernate-core\src\main\java\org\hibernate\metamodel\model\domain\internal\EmbeddableTypeImpl.java;EmbeddableTypeImpl.java;60;72;66;6;1;2;0;2
E:\workspace\java\hibernate-orm\hibernate-core\src\main\java\org\hibernate\cfg\ToOneBinder.java;ToOneBinder.java;60;3;2;1;1;2;0;2
E:\workspace\java\hibernate-orm\hibernate-core\src\main\java\org\hibernate\engine\transaction\jta\platform\internal\JtaPlatformInitiator.java;JtaPlatformInitiator.java;60;21;17;4;3;3;0;3
E:\workspace\java\hibernate-orm\hibernate-jipijapa\src\main\java\org\jboss\as\jpa\hibernate5\JBossAppServerJtaPlatform.java;JBossAppServerJtaPlatform.java;59;127;93;34;1;2;0;2
E:\workspace\java\hibernate-orm\hibernate-core\src\main\java\org\hibernate\persister\spi\PersisterFactory.java;PersisterFactory.java;59;16;8;8;1;1;0;1
E:\workspace\java\hibernate-orm\hibernate-core\src\main\java\org\hibernate\dialect\lock\OptimisticForceIncrementLockingStrategy.java;OptimisticForceIncrementLockingStrategy.java;59;4;2;2;2;2;0;2
E:\workspace\java\hibernate-orm\hibernate-core\src\main\java\org\hibernate\Version.java;Version.java;59;2;2;0;1;1;0;1
E:\workspace\java\hibernate-orm\hibernate-core\src\main\java\org\hibernate\graph\spi\GraphHelper.java;GraphHelper.java;58;92;75;17;1;2;0;2
E:\workspace\java\hibernate-orm\hibernate-core\src\main\java\org\hibernate\event\internal\DefaultFlushEventListener.java;DefaultFlushEventListener.java;58;10;6;4;2;2;0;2
E:\workspace\java\hibernate-orm\hibernate-ehcache\src\main\java\org\hibernate\cache\ehcache\internal\StrategyRegistrationProviderImpl.java;StrategyRegistrationProviderImpl.java;58;62;60;2;2;2;0;2
E:\workspace\java\hibernate-orm\hibernate-core\src\main\java\org\hibernate\dialect\lock\OptimisticLockingStrategy.java;OptimisticLockingStrategy.java;58;6;2;4;2;2;0;2
E:\workspace\java\hibernate-orm\hibernate-core\src\main\java\org\hibernate\cache\spi\support\DirectAccessRegionTemplate.java;DirectAccessRegionTemplate.java;57;95;76;19;2;5;1;4
E:\workspace\java\hibernate-orm\hibernate-core\src\main\java\org\hibernate\criterion\NullExpression.java;NullExpression.java;57;2;1;1;1;1;0;1
E:\workspace\java\hibernate-orm\hibernate-core\src\main\java\org\hibernate\query\ImmutableEntityUpdateQueryHandlingMode.java;ImmutableEntityUpdateQueryHandlingMode.java;57;57;57;0;1;1;0;1
E:\workspace\java\hibernate-orm\hibernate-core\src\main\java\org\hibernate\mapping\List.java;List.java;56;15;12;3;1;2;0;2
E:\workspace\java\hibernate-orm\hibernate-core\src\main\java\org\hibernate\service\spi\SessionFactoryServiceInitiator.java;SessionFactoryServiceInitiator.java;56;41;30;11;1;2;0;2
E:\workspace\java\hibernate-orm\hibernate-core\src\main\java\org\hibernate\type\SortedMapType.java;SortedMapType.java;56;10;9;1;1;1;0;1
E:\workspace\java\hibernate-orm\hibernate-spatial\src\main\java\org\hibernate\spatial\criterion\IsEmptyExpression.java;IsEmptyExpression.java;56;6;4;2;1;1;0;1
E:\workspace\java\hibernate-orm\hibernate-core\src\main\java\org\hibernate\cache\cfg\internal\CollectionDataCachingConfigImpl.java;CollectionDataCachingConfigImpl.java;56;56;56;0;1;1;0;1
E:\workspace\java\hibernate-orm\hibernate-core\src\main\java\org\hibernate\tool\schema\internal\exec\ScriptTargetOutputToStdout.java;ScriptTargetOutputToStdout.java;56;2;2;0;1;1;0;1
E:\workspace\java\hibernate-orm\hibernate-core\src\main\java\org\hibernate\type\IdentifierBagType.java;IdentifierBagType.java;56;10;9;1;1;1;0;1
E:\workspace\java\hibernate-orm\hibernate-core\src\main\java\org\hibernate\engine\transaction\jta\platform\internal\WildFlyStandAloneJtaPlatform.java;WildFlyStandAloneJtaPlatform.java;56;158;107;51;2;3;0;3
E:\workspace\java\hibernate-orm\hibernate-core\src\main\java\org\hibernate\boot\model\source\internal\hbm\CommaSeparatedStringHelper.java;CommaSeparatedStringHelper.java;55;30;21;9;1;2;0;2
E:\workspace\java\hibernate-orm\hibernate-core\src\main\java\org\hibernate\type\ProcedureParameterExtractionAware.java;ProcedureParameterExtractionAware.java;55;78;39;39;1;2;0;2
E:\workspace\java\hibernate-orm\hibernate-core\src\main\java\org\hibernate\tool\schema\extract\internal\SequenceInformationExtractorCUBRIDDatabaseImpl.java;SequenceInformationExtractorCUBRIDDatabaseImpl.java;55;55;55;0;1;1;0;1
E:\workspace\java\hibernate-orm\hibernate-core\src\main\java\org\hibernate\dialect\pagination\NoopLimitHandler.java;NoopLimitHandler.java;55;9;8;1;1;1;1;0
E:\workspace\java\hibernate-orm\hibernate-core\src\main\java\org\hibernate\engine\query\spi\NamedParameterDescriptor.java;NamedParameterDescriptor.java;55;1;1;0;1;1;0;1
E:\workspace\java\hibernate-orm\hibernate-core\src\main\java\org\hibernate\type\SortedSetType.java;SortedSetType.java;55;11;10;1;1;1;0;1
E:\workspace\java\hibernate-orm\hibernate-core\src\main\java\org\hibernate\engine\jdbc\internal\BinaryStreamImpl.java;BinaryStreamImpl.java;54;2;1;1;1;1;0;1
E:\workspace\java\hibernate-orm\hibernate-core\src\main\java\org\hibernate\annotations\CollectionType.java;CollectionType.java;54;14;13;1;1;1;0;1
E:\workspace\java\hibernate-orm\hibernate-core\src\main\java\org\hibernate\type\BagType.java;BagType.java;54;11;9;2;1;1;0;1
E:\workspace\java\hibernate-orm\hibernate-core\src\main\java\org\hibernate\loader\plan\build\internal\FetchGraphLoadPlanBuildingStrategy.java;FetchGraphLoadPlanBuildingStrategy.java;54;21;16;5;1;1;0;1
E:\workspace\java\hibernate-orm\hibernate-jipijapa\src\main\java\org\jboss\as\jpa\hibernate5\HibernateExtendedBeanManager.java;HibernateExtendedBeanManager.java;54;118;86;32;1;3;0;3
E:\workspace\java\hibernate-orm\hibernate-core\src\main\java\org\hibernate\resource\beans\internal\FallbackBeanInstanceProducer.java;FallbackBeanInstanceProducer.java;54;56;55;1;2;2;0;2
E:\workspace\java\hibernate-orm\hibernate-core\src\main\java\org\hibernate\event\spi\PostLoadEvent.java;PostLoadEvent.java;54;2;1;1;1;1;0;1
E:\workspace\java\hibernate-orm\hibernate-spatial\src\main\java\org\hibernate\spatial\criterion\HavingSridExpression.java;HavingSridExpression.java;54;1;0;1;1;1;0;1
E:\workspace\java\hibernate-orm\hibernate-core\src\main\java\org\hibernate\query\criteria\internal\expression\function\BasicFunctionExpression.java;BasicFunctionExpression.java;54;4;0;4;1;1;0;1
E:\workspace\java\hibernate-orm\hibernate-core\src\main\java\org\hibernate\jpa\event\internal\ListenerCallback.java;ListenerCallback.java;54;7;3;4;2;2;0;2
E:\workspace\java\hibernate-orm\hibernate-core\src\main\java\org\hibernate\tool\schema\extract\internal\SequenceNameExtractorImpl.java;SequenceNameExtractorImpl.java;54;54;54;0;1;1;0;1
E:\workspace\java\hibernate-orm\hibernate-core\src\main\java\org\hibernate\hql\spi\QueryTranslatorFactory.java;QueryTranslatorFactory.java;54;2;1;1;1;1;0;1
E:\workspace\java\hibernate-orm\hibernate-core\src\main\java\org\hibernate\Metamodel.java;Metamodel.java;54;10;9;1;1;1;0;1
E:\workspace\java\hibernate-orm\hibernate-core\src\main\java\org\hibernate\hql\internal\QueryTranslatorFactoryInitiator.java;QueryTranslatorFactoryInitiator.java;54;17;7;10;1;2;0;2
E:\workspace\java\hibernate-orm\hibernate-jipijapa\src\main\java\org\jboss\as\jpa\hibernate5\management\HibernateManagementAdaptor.java;HibernateManagementAdaptor.java;53;115;84;31;1;2;0;2
E:\workspace\java\hibernate-orm\hibernate-core\src\main\java\org\hibernate\type\SetType.java;SetType.java;53;10;9;1;1;1;0;1
E:\workspace\java\hibernate-orm\hibernate-core\src\main\java\org\hibernate\query\criteria\internal\expression\SizeOfPluralAttributeExpression.java;SizeOfPluralAttributeExpression.java;53;4;0;4;1;1;0;1
E:\workspace\java\hibernate-orm\hibernate-core\src\main\java\org\hibernate\boot\model\relational\NamedAuxiliaryDatabaseObject.java;NamedAuxiliaryDatabaseObject.java;53;8;7;1;1;1;0;1
E:\workspace\java\hibernate-orm\hibernate-core\src\main\java\org\hibernate\stat\EntityStatistics.java;EntityStatistics.java;53;32;28;4;1;1;0;1
E:\workspace\java\hibernate-orm\hibernate-core\src\main\java\org\hibernate\cache\spi\Region.java;Region.java;53;102;28;74;2;3;1;2
E:\workspace\java\hibernate-orm\hibernate-core\src\main\java\org\hibernate\tool\schema\internal\exec\AbstractScriptSourceInput.java;AbstractScriptSourceInput.java;53;10;9;1;1;1;0;1
E:\workspace\java\hibernate-orm\hibernate-core\src\main\java\org\hibernate\criterion\IdentifierEqExpression.java;IdentifierEqExpression.java;53;2;1;1;1;1;0;1
E:\workspace\java\hibernate-orm\hibernate-core\src\main\java\org\hibernate\action\internal\EntityVerifyVersionProcess.java;EntityVerifyVersionProcess.java;53;13;5;8;1;1;0;1
E:\workspace\java\hibernate-orm\hibernate-core\src\main\java\org\hibernate\jpa\event\internal\EmbeddableCallback.java;EmbeddableCallback.java;53;61;57;4;3;3;0;3
E:\workspace\java\hibernate-orm\hibernate-core\src\main\java\org\hibernate\tool\schema\extract\internal\SequenceInformationExtractorIngresDatabaseImpl.java;SequenceInformationExtractorIngresDatabaseImpl.java;52;52;52;0;1;1;0;1
E:\workspace\java\hibernate-orm\hibernate-spatial\src\main\java\org\hibernate\spatial\jts\EnvelopeAdapter.java;EnvelopeAdapter.java;52;12;7;5;1;2;0;2
E:\workspace\java\hibernate-orm\hibernate-core\src\main\java\org\hibernate\jpa\event\internal\CallbacksFactory.java;CallbacksFactory.java;51;51;51;0;1;1;0;1
E:\workspace\java\hibernate-orm\hibernate-core\src\main\java\org\hibernate\stat\internal\SessionStatisticsImpl.java;SessionStatisticsImpl.java;51;10;5;5;2;2;0;2
E:\workspace\java\hibernate-orm\hibernate-core\src\main\java\org\hibernate\dialect\SybaseDialect.java;SybaseDialect.java;51;5;5;0;1;1;0;1
E:\workspace\java\hibernate-orm\hibernate-spatial\src\main\java\org\hibernate\spatial\JTSGeometryType.java;JTSGeometryType.java;51;22;11;11;1;2;0;2
E:\workspace\java\hibernate-orm\hibernate-core\src\main\java\org\hibernate\stat\NaturalIdStatistics.java;NaturalIdStatistics.java;51;53;52;1;1;2;1;1
E:\workspace\java\hibernate-orm\hibernate-core\src\main\java\org\hibernate\event\internal\DefaultDirtyCheckEventListener.java;DefaultDirtyCheckEventListener.java;51;8;5;3;1;1;0;1
E:\workspace\java\hibernate-orm\hibernate-core\src\main\java\org\hibernate\criterion\NotNullExpression.java;NotNullExpression.java;51;2;1;1;1;1;0;1
E:\workspace\java\hibernate-orm\hibernate-core\src\main\java\org\hibernate\query\criteria\internal\predicate\AbstractSimplePredicate.java;AbstractSimplePredicate.java;51;5;0;5;1;1;0;1
E:\workspace\java\hibernate-orm\hibernate-core\src\main\java\org\hibernate\type\EmbeddedComponentType.java;EmbeddedComponentType.java;50;11;10;1;1;1;0;1
E:\workspace\java\hibernate-orm\hibernate-core\src\main\java\org\hibernate\tool\schema\extract\internal\SequenceInformationExtractorHANADatabaseImpl.java;SequenceInformationExtractorHANADatabaseImpl.java;50;50;50;0;1;1;0;1
E:\workspace\java\hibernate-orm\hibernate-core\src\main\java\org\hibernate\tool\schema\extract\internal\SequenceInformationExtractorInformixDatabaseImpl.java;SequenceInformationExtractorInformixDatabaseImpl.java;50;50;50;0;1;1;0;1
E:\workspace\java\hibernate-orm\hibernate-core\src\main\java\org\hibernate\usertype\DynamicParameterizedType.java;DynamicParameterizedType.java;50;32;16;16;1;1;0;1
E:\workspace\java\hibernate-orm\hibernate-core\src\main\java\org\hibernate\tool\schema\extract\internal\SequenceInformationExtractorDB2DatabaseImpl.java;SequenceInformationExtractorDB2DatabaseImpl.java;50;50;50;0;1;1;0;1
E:\workspace\java\hibernate-orm\hibernate-core\src\main\java\org\hibernate\event\spi\PersistEvent.java;PersistEvent.java;50;2;1;1;1;1;0;1
E:\workspace\java\hibernate-orm\hibernate-core\src\main\java\org\hibernate\proxy\map\MapLazyInitializer.java;MapLazyInitializer.java;50;16;16;0;1;1;0;1
E:\workspace\java\hibernate-orm\hibernate-jipijapa\src\main\java\org\jboss\as\jpa\hibernate5\TwoPhaseBootstrapImpl.java;TwoPhaseBootstrapImpl.java;50;94;72;22;1;2;0;2
E:\workspace\java\hibernate-orm\hibernate-core\src\main\java\org\hibernate\tool\schema\extract\internal\SequenceInformationExtractorOracleDatabaseImpl.java;SequenceInformationExtractorOracleDatabaseImpl.java;50;50;50;0;1;1;0;1
E:\workspace\java\hibernate-orm\hibernate-core\src\main\java\org\hibernate\criterion\BetweenExpression.java;BetweenExpression.java;50;2;1;1;1;1;0;1
E:\workspace\java\hibernate-orm\hibernate-core\src\main\java\org\hibernate\procedure\spi\CallableStatementSupport.java;CallableStatementSupport.java;50;2;1;1;1;1;0;1
E:\workspace\java\hibernate-orm\hibernate-core\src\main\java\org\hibernate\tool\hbm2ddl\SingleLineSqlCommandExtractor.java;SingleLineSqlCommandExtractor.java;49;2;1;1;1;1;0;1
E:\workspace\java\hibernate-orm\hibernate-core\src\main\java\org\hibernate\sql\ast\Clause.java;Clause.java;49;49;49;0;1;1;0;1
E:\workspace\java\hibernate-orm\hibernate-core\src\main\java\org\hibernate\action\internal\EntityIncrementVersionProcess.java;EntityIncrementVersionProcess.java;49;11;7;4;1;1;0;1
E:\workspace\java\hibernate-orm\hibernate-core\src\main\java\org\hibernate\query\procedure\ProcedureParameter.java;ProcedureParameter.java;49;4;4;0;1;1;0;1
E:\workspace\java\hibernate-orm\hibernate-core\src\main\java\org\hibernate\event\internal\PostUpdateEventListenerStandardImpl.java;PostUpdateEventListenerStandardImpl.java;49;53;51;2;2;3;0;3
E:\workspace\java\hibernate-orm\hibernate-core\src\main\java\org\hibernate\graph\spi\SubGraphImplementor.java;SubGraphImplementor.java;49;53;51;2;1;2;0;2
E:\workspace\java\hibernate-orm\hibernate-core\src\main\java\org\hibernate\internal\ConnectionObserverStatsBridge.java;ConnectionObserverStatsBridge.java;49;15;9;6;2;2;0;2
E:\workspace\java\hibernate-orm\hibernate-jipijapa\src\main\java\org\jboss\as\jpa\hibernate5\VirtualFileInputStreamAccess.java;VirtualFileInputStreamAccess.java;49;93;71;22;1;2;0;2
E:\workspace\java\hibernate-orm\hibernate-core\src\main\java\org\hibernate\service\spi\ServiceRegistryImplementor.java;ServiceRegistryImplementor.java;49;13;9;4;1;2;0;2
E:\workspace\java\hibernate-orm\hibernate-core\src\main\java\org\hibernate\query\criteria\internal\expression\ListIndexExpression.java;ListIndexExpression.java;49;4;0;4;1;1;0;1
E:\workspace\java\hibernate-orm\hibernate-core\src\main\java\org\hibernate\event\internal\EntityCopyAllowedObserver.java;EntityCopyAllowedObserver.java;49;13;11;2;1;1;0;1
E:\workspace\java\hibernate-orm\hibernate-core\src\main\java\org\hibernate\dialect\HANARowStoreDialect.java;HANARowStoreDialect.java;49;11;9;2;1;1;0;1
E:\workspace\java\hibernate-orm\hibernate-core\src\main\java\org\hibernate\cache\spi\support\RegionNameQualifier.java;RegionNameQualifier.java;48;58;53;5;1;2;0;2
E:\workspace\java\hibernate-orm\hibernate-core\src\main\java\org\hibernate\jpa\event\internal\EntityCallback.java;EntityCallback.java;48;7;3;4;2;2;0;2
E:\workspace\java\hibernate-orm\hibernate-spatial\src\main\java\org\hibernate\spatial\integration\SpatialService.java;SpatialService.java;48;1;0;1;1;1;0;1
E:\workspace\java\hibernate-orm\hibernate-jcache\src\main\java\org\hibernate\cache\jcache\ConfigSettings.java;ConfigSettings.java;47;33;33;0;2;2;0;2
E:\workspace\java\hibernate-orm\hibernate-core\src\main\java\org\hibernate\bytecode\spi\ProxyFactoryFactory.java;ProxyFactoryFactory.java;47;2;1;1;1;1;0;1
E:\workspace\java\hibernate-orm\hibernate-core\src\main\java\org\hibernate\annotations\UpdateTimestamp.java;UpdateTimestamp.java;47;7;6;1;1;1;0;1
E:\workspace\java\hibernate-orm\hibernate-core\src\main\java\org\hibernate\cache\cfg\spi\EntityDataCachingConfig.java;EntityDataCachingConfig.java;47;47;47;0;1;1;0;1
E:\workspace\java\hibernate-orm\hibernate-core\src\main\java\org\hibernate\bytecode\internal\none\BytecodeProviderImpl.java;BytecodeProviderImpl.java;47;47;47;0;1;1;0;1
E:\workspace\java\hibernate-orm\hibernate-core\src\main\java\org\hibernate\annotations\CreationTimestamp.java;CreationTimestamp.java;47;7;6;1;1;1;0;1
E:\workspace\java\hibernate-orm\hibernate-core\src\main\java\org\hibernate\stat\CollectionStatistics.java;CollectionStatistics.java;47;24;22;2;1;1;0;1
E:\workspace\java\hibernate-orm\hibernate-core\src\main\java\org\hibernate\cache\spi\support\NaturalIdReadOnlyAccess.java;NaturalIdReadOnlyAccess.java;47;47;47;0;1;2;0;2
E:\workspace\java\hibernate-orm\hibernate-core\src\main\java\org\hibernate\tool\schema\extract\internal\SequenceInformationExtractorTimesTenDatabaseImpl.java;SequenceInformationExtractorTimesTenDatabaseImpl.java;47;47;47;0;1;1;0;1
E:\workspace\java\hibernate-orm\hibernate-core\src\main\java\org\hibernate\tool\schema\extract\internal\SequenceInformationExtractorSAPDBDatabaseImpl.java;SequenceInformationExtractorSAPDBDatabaseImpl.java;47;47;47;0;1;1;0;1
E:\workspace\java\hibernate-orm\hibernate-core\src\main\java\org\hibernate\mapping\Value.java;Value.java;46;1;1;0;1;1;1;0
E:\workspace\java\hibernate-orm\hibernate-core\src\main\java\org\hibernate\loader\internal\AliasConstantsHelper.java;AliasConstantsHelper.java;46;46;46;0;1;1;1;0
E:\workspace\java\hibernate-orm\hibernate-core\src\main\java\org\hibernate\metamodel\model\domain\internal\MappedSuperclassTypeImpl.java;MappedSuperclassTypeImpl.java;46;54;50;4;1;2;0;2
E:\workspace\java\hibernate-orm\hibernate-core\src\main\java\org\hibernate\loader\collection\CollectionJoinWalker.java;CollectionJoinWalker.java;46;2;1;1;1;1;0;1
E:\workspace\java\hibernate-orm\hibernate-core\src\main\java\org\hibernate\graph\AttributeNode.java;AttributeNode.java;46;46;46;0;1;1;0;1
E:\workspace\java\hibernate-orm\hibernate-core\src\main\java\org\hibernate\hql\internal\ast\tree\ResolvableNode.java;ResolvableNode.java;46;2;1;1;1;1;0;1
E:\workspace\java\hibernate-orm\hibernate-core\src\main\java\org\hibernate\service\spi\Manageable.java;Manageable.java;45;14;11;3;1;1;0;1
E:\workspace\java\hibernate-orm\hibernate-core\src\main\java\org\hibernate\mapping\Bag.java;Bag.java;45;16;13;3;1;2;0;2
E:\workspace\java\hibernate-orm\hibernate-envers\src\main\java\org\hibernate\envers\strategy\spi\MappingContext.java;MappingContext.java;45;45;45;0;1;1;0;1
E:\workspace\java\hibernate-orm\hibernate-core\src\main\java\org\hibernate\tool\schema\internal\exec\GenerationTargetToStdout.java;GenerationTargetToStdout.java;45;3;3;0;1;1;0;1
E:\workspace\java\hibernate-orm\hibernate-core\src\main\java\org\hibernate\cache\spi\AbstractCacheTransactionSynchronization.java;AbstractCacheTransactionSynchronization.java;45;75;60;15;2;2;0;2
E:\workspace\java\hibernate-orm\hibernate-core\src\main\java\org\hibernate\boot\model\naming\ImplicitNamingStrategyComponentPathImpl.java;ImplicitNamingStrategyComponentPathImpl.java;45;2;1;1;1;1;0;1
E:\workspace\java\hibernate-orm\hibernate-core\src\main\java\org\hibernate\metamodel\model\domain\internal\MapAttributeImpl.java;MapAttributeImpl.java;45;57;51;6;1;2;0;2
E:\workspace\java\hibernate-orm\hibernate-core\src\main\java\org\hibernate\graph\spi\RootGraphImplementor.java;RootGraphImplementor.java;44;56;50;6;1;2;0;2
E:\workspace\java\hibernate-orm\hibernate-core\src\main\java\org\hibernate\boot\xsd\XsdDescriptor.java;XsdDescriptor.java;44;48;46;2;2;2;0;2
E:\workspace\java\hibernate-orm\hibernate-ehcache\src\main\java\org\hibernate\cache\ehcache\internal\DeprecationLogger.java;DeprecationLogger.java;44;44;44;0;1;1;0;1
E:\workspace\java\hibernate-orm\hibernate-spatial\src\main\java\org\hibernate\spatial\dialect\sqlserver\SqlServerMethod.java;SqlServerMethod.java;44;2;1;1;1;1;0;1
E:\workspace\java\hibernate-orm\hibernate-core\src\main\java\org\hibernate\type\ProcedureParameterNamedBinder.java;ProcedureParameterNamedBinder.java;44;44;22;22;1;2;0;2
E:\workspace\java\hibernate-orm\hibernate-core\src\main\java\org\hibernate\type\StandardBasicTypeTemplate.java;StandardBasicTypeTemplate.java;44;44;44;0;1;1;0;1
E:\workspace\java\hibernate-orm\hibernate-core\src\main\java\org\hibernate\jpa\internal\util\PersistenceUnitTransactionTypeHelper.java;PersistenceUnitTransactionTypeHelper.java;44;6;3;3;1;1;0;1
E:\workspace\java\hibernate-orm\hibernate-core\src\main\java\org\hibernate\tool\schema\internal\exec\ScriptSourceInputFromReader.java;ScriptSourceInputFromReader.java;44;5;5;0;1;1;0;1
E:\workspace\java\hibernate-orm\hibernate-core\src\main\java\org\hibernate\jpa\event\spi\jpa\ExtendedBeanManager.java;ExtendedBeanManager.java;44;50;33;17;2;3;0;3
E:\workspace\java\hibernate-orm\hibernate-core\src\main\java\org\hibernate\type\VersionType.java;VersionType.java;43;58;29;29;1;2;0;2
E:\workspace\java\hibernate-orm\hibernate-core\src\main\java\org\hibernate\service\internal\SessionFactoryServiceRegistryFactoryImpl.java;SessionFactoryServiceRegistryFactoryImpl.java;43;8;4;4;2;2;0;2
E:\workspace\java\hibernate-orm\hibernate-core\src\main\java\org\hibernate\type\descriptor\sql\spi\SqlTypeDescriptorRegistry.java;SqlTypeDescriptorRegistry.java;43;51;47;4;1;2;0;2
E:\workspace\java\hibernate-orm\hibernate-core\src\main\java\org\hibernate\type\BlobType.java;BlobType.java;42;40;20;20;1;2;1;1
E:\workspace\java\hibernate-orm\hibernate-core\src\main\java\org\hibernate\boot\spi\AbstractDelegatingSessionFactoryBuilderImplementor.java;AbstractDelegatingSessionFactoryBuilderImplementor.java;42;16;5;11;2;4;0;4
E:\workspace\java\hibernate-orm\hibernate-core\src\main\java\org\hibernate\resource\beans\internal\Helper.java;Helper.java;42;90;45;45;1;5;0;5
E:\workspace\java\hibernate-orm\hibernate-core\src\main\java\org\hibernate\annotations\FlushModeType.java;FlushModeType.java;42;2;1;1;1;1;0;1
E:\workspace\java\hibernate-orm\hibernate-core\src\main\java\org\hibernate\engine\query\spi\NativeQueryInterpreterInitiator.java;NativeQueryInterpreterInitiator.java;42;22;14;8;1;2;0;2
E:\workspace\java\hibernate-orm\hibernate-core\src\main\java\org\hibernate\engine\spi\CacheInitiator.java;CacheInitiator.java;42;13;10;3;1;2;0;2
E:\workspace\java\hibernate-orm\hibernate-core\src\main\java\org\hibernate\tool\schema\extract\internal\SequenceInformationExtractorDerbyDatabaseImpl.java;SequenceInformationExtractorDerbyDatabaseImpl.java;42;42;42;0;1;1;0;1
E:\workspace\java\hibernate-orm\hibernate-vibur\src\main\java\org\hibernate\vibur\internal\StrategyRegistrationProviderImpl.java;StrategyRegistrationProviderImpl.java;41;77;59;18;2;2;0;2
E:\workspace\java\hibernate-orm\hibernate-jcache\src\main\java\org\hibernate\cache\jcache\internal\StrategyRegistrationProviderImpl.java;StrategyRegistrationProviderImpl.java;41;73;57;16;2;2;0;2
E:\workspace\java\hibernate-orm\hibernate-core\src\main\java\org\hibernate\cache\cfg\spi\DomainDataRegionConfig.java;DomainDataRegionConfig.java;41;43;42;1;2;2;1;1
E:\workspace\java\hibernate-orm\hibernate-core\src\main\java\org\hibernate\hql\internal\CollectionSubqueryFactory.java;CollectionSubqueryFactory.java;41;3;1;2;1;1;0;1
E:\workspace\java\hibernate-orm\hibernate-core\src\main\java\org\hibernate\event\service\internal\EventListenerServiceInitiator.java;EventListenerServiceInitiator.java;41;24;15;9;1;3;0;3
E:\workspace\java\hibernate-orm\hibernate-core\src\main\java\org\hibernate\query\criteria\internal\expression\NullLiteralExpression.java;NullLiteralExpression.java;41;12;8;4;1;1;0;1
E:\workspace\java\hibernate-orm\hibernate-core\src\main\java\org\hibernate\dialect\identity\Oracle12cIdentityColumnSupport.java;Oracle12cIdentityColumnSupport.java;41;5;5;0;1;1;1;0
E:\workspace\java\hibernate-orm\hibernate-core\src\main\java\org\hibernate\resource\transaction\backend\jta\internal\JtaTransactionAdapter.java;JtaTransactionAdapter.java;41;12;6;6;1;1;0;1
E:\workspace\java\hibernate-orm\hibernate-core\src\main\java\org\hibernate\type\NClobType.java;NClobType.java;41;37;18;19;1;2;1;1
E:\workspace\java\hibernate-orm\hibernate-core\src\main\java\org\hibernate\tool\schema\internal\exec\AbstractScriptTargetOutput.java;AbstractScriptTargetOutput.java;41;2;1;1;1;1;0;1
E:\workspace\java\hibernate-orm\hibernate-core\src\main\java\org\hibernate\type\ClobType.java;ClobType.java;41;37;18;19;1;2;1;1
E:\workspace\java\hibernate-orm\hibernate-core\src\main\java\org\hibernate\cache\spi\QuerySpacesHelper.java;QuerySpacesHelper.java;41;41;41;0;1;1;0;1
E:\workspace\java\hibernate-orm\hibernate-core\src\main\java\org\hibernate\cache\spi\support\CollectionNonStrictReadWriteAccess.java;CollectionNonStrictReadWriteAccess.java;40;8;7;1;1;2;0;2
E:\workspace\java\hibernate-orm\hibernate-core\src\main\java\org\hibernate\cache\spi\support\AbstractRegion.java;AbstractRegion.java;40;76;58;18;2;3;1;2
E:\workspace\java\hibernate-orm\hibernate-core\src\main\java\org\hibernate\internal\ExceptionMapperStandardImpl.java;ExceptionMapperStandardImpl.java;40;2;0;2;1;2;0;2
E:\workspace\java\hibernate-orm\hibernate-core\src\main\java\org\hibernate\boot\model\convert\internal\ClassBasedConverterDescriptor.java;ClassBasedConverterDescriptor.java;40;2;1;1;1;1;0;1
E:\workspace\java\hibernate-orm\hibernate-core\src\main\java\org\hibernate\service\internal\StandardSessionFactoryServiceInitiators.java;StandardSessionFactoryServiceInitiators.java;40;10;4;6;1;1;0;1
E:\workspace\java\hibernate-orm\hibernate-core\src\main\java\org\hibernate\resource\beans\container\spi\FallbackContainedBean.java;FallbackContainedBean.java;40;40;40;0;1;1;0;1
E:\workspace\java\hibernate-orm\hibernate-core\src\main\java\org\hibernate\property\access\internal\PropertyAccessStrategyMapImpl.java;PropertyAccessStrategyMapImpl.java;40;14;14;0;1;1;0;1
E:\workspace\java\hibernate-orm\hibernate-core\src\main\java\org\hibernate\bytecode\internal\none\DisallowedProxyFactory.java;DisallowedProxyFactory.java;40;40;40;0;1;1;0;1
E:\workspace\java\hibernate-orm\hibernate-core\src\main\java\org\hibernate\bytecode\enhance\spi\interceptor\BytecodeLazyAttributeInterceptor.java;BytecodeLazyAttributeInterceptor.java;40;40;40;0;1;1;0;1
E:\workspace\java\hibernate-orm\hibernate-core\src\main\java\org\hibernate\engine\internal\CacheHelper.java;CacheHelper.java;40;6;3;3;1;1;0;1
E:\workspace\java\hibernate-orm\hibernate-ehcache\src\main\java\org\hibernate\cache\ehcache\ConfigSettings.java;ConfigSettings.java;40;46;43;3;2;6;0;6
E:\workspace\java\hibernate-orm\hibernate-core\src\main\java\org\hibernate\id\AbstractPostInsertGenerator.java;AbstractPostInsertGenerator.java;40;5;5;0;1;1;0;1
E:\workspace\java\hibernate-orm\hibernate-core\src\main\java\org\hibernate\query\internal\QueryParameterImpl.java;QueryParameterImpl.java;40;2;1;1;1;1;0;1
E:\workspace\java\hibernate-orm\hibernate-core\src\main\java\org\hibernate\tool\schema\spi\ScriptSourceInput.java;ScriptSourceInput.java;39;3;2;1;1;1;0;1
E:\workspace\java\hibernate-orm\hibernate-core\src\main\java\org\hibernate\jpa\event\spi\CallbackBuilder.java;CallbackBuilder.java;39;11;10;1;2;2;0;2
E:\workspace\java\hibernate-orm\hibernate-c3p0\src\main\java\org\hibernate\c3p0\internal\StrategyRegistrationProviderImpl.java;StrategyRegistrationProviderImpl.java;39;29;13;16;1;1;0;1
E:\workspace\java\hibernate-orm\hibernate-core\src\main\java\org\hibernate\mapping\IdentifierBag.java;IdentifierBag.java;39;15;12;3;1;2;0;2
E:\workspace\java\hibernate-orm\hibernate-hikaricp\src\main\java\org\hibernate\hikaricp\internal\StrategyRegistrationProviderImpl.java;StrategyRegistrationProviderImpl.java;39;24;11;13;1;1;0;1
E:\workspace\java\hibernate-orm\hibernate-core\src\main\java\org\hibernate\cache\spi\package-info.java;package-info.java;39;39;39;0;1;1;0;1
E:\workspace\java\hibernate-orm\hibernate-proxool\src\main\java\org\hibernate\proxool\internal\StrategyRegistrationProviderImpl.java;StrategyRegistrationProviderImpl.java;39;27;12;15;1;1;0;1
E:\workspace\java\hibernate-orm\hibernate-core\src\main\java\org\hibernate\stat\CacheableDataStatistics.java;CacheableDataStatistics.java;39;43;41;2;2;3;0;3
E:\workspace\java\hibernate-orm\hibernate-core\src\main\java\org\hibernate\stat\internal\StatsHelper.java;StatsHelper.java;38;38;38;0;1;1;0;1
E:\workspace\java\hibernate-orm\hibernate-envers\src\main\java\org\hibernate\envers\strategy\ValidityAuditStrategy.java;ValidityAuditStrategy.java;38;489;63;426;2;3;1;2
E:\workspace\java\hibernate-orm\hibernate-core\src\main\java\org\hibernate\cache\cfg\spi\DomainDataCachingConfig.java;DomainDataCachingConfig.java;38;38;38;0;1;1;0;1
E:\workspace\java\hibernate-orm\hibernate-core\src\main\java\org\hibernate\graph\internal\AbstractGraphNode.java;AbstractGraphNode.java;38;38;38;0;1;1;0;1
E:\workspace\java\hibernate-orm\hibernate-core\src\main\java\org\hibernate\internal\util\compare\RowVersionComparator.java;RowVersionComparator.java;38;3;2;1;1;1;0;1
E:\workspace\java\hibernate-orm\hibernate-core\src\main\java\org\hibernate\usertype\EnhancedUserType.java;EnhancedUserType.java;38;6;3;3;1;1;0;1
E:\workspace\java\hibernate-orm\hibernate-core\src\main\java\org\hibernate\usertype\UserVersionType.java;UserVersionType.java;37;63;31;32;1;2;0;2
E:\workspace\java\hibernate-orm\hibernate-core\src\main\java\org\hibernate\stat\SessionStatistics.java;SessionStatistics.java;37;8;4;4;1;1;0;1
E:\workspace\java\hibernate-orm\hibernate-core\src\main\java\org\hibernate\dialect\DB2390V8Dialect.java;DB2390V8Dialect.java;37;2;1;1;1;1;0;1
E:\workspace\java\hibernate-orm\hibernate-agroal\src\main\java\org\hibernate\agroal\internal\StrategyRegistrationProviderImpl.java;StrategyRegistrationProviderImpl.java;37;71;54;17;2;2;0;2
E:\workspace\java\hibernate-orm\hibernate-core\src\main\java\org\hibernate\resource\jdbc\spi\JdbcObserver.java;JdbcObserver.java;37;3;3;0;1;1;0;1
E:\workspace\java\hibernate-orm\hibernate-jipijapa\src\main\java\org\jboss\as\jpa\hibernate5\VirtualFileSystemArchiveDescriptorFactory.java;VirtualFileSystemArchiveDescriptorFactory.java;37;57;47;10;1;2;0;2
E:\workspace\java\hibernate-orm\hibernate-core\src\main\java\org\hibernate\boot\archive\scan\internal\DisabledScanner.java;DisabledScanner.java;37;37;37;0;1;1;0;1
E:\workspace\java\hibernate-orm\hibernate-core\src\main\java\org\hibernate\metamodel\model\domain\internal\BasicTypeImpl.java;BasicTypeImpl.java;37;43;40;3;1;2;0;2
E:\workspace\java\hibernate-orm\hibernate-core\src\main\java\org\hibernate\internal\log\UnsupportedLogger.java;UnsupportedLogger.java;37;37;37;0;1;1;0;1
E:\workspace\java\hibernate-orm\hibernate-core\src\main\java\org\hibernate\event\service\spi\EventListenerRegistry.java;EventListenerRegistry.java;36;19;11;8;1;1;0;1
E:\workspace\java\hibernate-orm\hibernate-core\src\main\java\org\hibernate\resource\beans\spi\ProvidedInstanceManagedBeanImpl.java;ProvidedInstanceManagedBeanImpl.java;36;5;0;5;1;1;0;1
E:\workspace\java\hibernate-orm\hibernate-core\src\main\java\org\hibernate\type\descriptor\java\BasicJavaDescriptor.java;BasicJavaDescriptor.java;36;36;36;0;1;1;0;1
E:\workspace\java\hibernate-orm\hibernate-core\src\main\java\org\hibernate\engine\transaction\jta\platform\internal\AtomikosJtaPlatform.java;AtomikosJtaPlatform.java;36;36;36;0;1;1;0;1
E:\workspace\java\hibernate-orm\hibernate-core\src\main\java\org\hibernate\resource\beans\spi\ManagedBeanRegistry.java;ManagedBeanRegistry.java;36;35;9;26;1;1;0;1
E:\workspace\java\hibernate-orm\hibernate-core\src\main\java\org\hibernate\bytecode\internal\bytebuddy\ProxyFactoryFactoryImpl.java;ProxyFactoryFactoryImpl.java;36;22;16;6;2;2;0;2
E:\workspace\java\hibernate-orm\hibernate-core\src\main\java\org\hibernate\service\spi\SessionFactoryServiceRegistryFactory.java;SessionFactoryServiceRegistryFactory.java;36;7;4;3;2;2;0;2
E:\workspace\java\hibernate-orm\hibernate-core\src\main\java\org\hibernate\query\criteria\internal\expression\PathTypeExpression.java;PathTypeExpression.java;36;4;0;4;1;1;0;1
E:\workspace\java\hibernate-orm\hibernate-core\src\main\java\org\hibernate\loader\plan\exec\internal\EntityReferenceAliasesImpl.java;EntityReferenceAliasesImpl.java;36;4;3;1;1;1;0;1
E:\workspace\java\hibernate-orm\hibernate-core\src\main\java\org\hibernate\tool\schema\extract\internal\SequenceInformationExtractorH2DatabaseImpl.java;SequenceInformationExtractorH2DatabaseImpl.java;35;70;13;57;1;1;0;1
E:\workspace\java\hibernate-orm\hibernate-core\src\main\java\org\hibernate\cache\cfg\spi\DomainDataRegionBuildingContext.java;DomainDataRegionBuildingContext.java;35;35;35;0;1;1;0;1
E:\workspace\java\hibernate-orm\hibernate-spatial\src\main\java\org\hibernate\spatial\HibernateSpatialConfigurationSettings.java;HibernateSpatialConfigurationSettings.java;35;22;14;8;1;2;0;2
E:\workspace\java\hibernate-orm\hibernate-core\src\main\java\org\hibernate\boot\spi\SessionFactoryBuilderImplementor.java;SessionFactoryBuilderImplementor.java;35;42;15;27;2;3;0;3
E:\workspace\java\hibernate-orm\hibernate-core\src\main\java\org\hibernate\mapping\PrimitiveArray.java;PrimitiveArray.java;35;15;12;3;1;2;0;2
E:\workspace\java\hibernate-orm\hibernate-core\src\main\java\org\hibernate\cache\spi\support\package-info.java;package-info.java;34;34;34;0;1;1;0;1
E:\workspace\java\hibernate-orm\hibernate-core\src\main\java\org\hibernate\metamodel\model\domain\BasicDomainType.java;BasicDomainType.java;34;34;34;0;1;1;0;1
E:\workspace\java\hibernate-orm\hibernate-core\src\main\java\org\hibernate\type\OrderedMapType.java;OrderedMapType.java;34;10;9;1;1;1;0;1
E:\workspace\java\hibernate-orm\hibernate-spatial\src\main\java\org\hibernate\spatial\HSMessageLogger.java;HSMessageLogger.java;34;2;1;1;1;1;0;1
E:\workspace\java\hibernate-orm\hibernate-core\src\main\java\org\hibernate\type\OrderedSetType.java;OrderedSetType.java;34;10;9;1;1;1;0;1
E:\workspace\java\hibernate-orm\hibernate-core\src\main\java\org\hibernate\cfg\annotations\SetBinder.java;SetBinder.java;34;2;1;1;1;1;0;1
E:\workspace\java\hibernate-orm\hibernate-core\src\main\java\org\hibernate\proxy\map\SerializableMapProxy.java;SerializableMapProxy.java;34;34;34;0;1;1;0;1
E:\workspace\java\hibernate-orm\hibernate-core\src\main\java\org\hibernate\criterion\PropertiesSubqueryExpression.java;PropertiesSubqueryExpression.java;34;3;1;2;1;1;0;1
E:\workspace\java\hibernate-orm\hibernate-core\src\main\java\org\hibernate\bytecode\enhance\spi\Enhancer.java;Enhancer.java;33;4;4;0;1;1;0;1
E:\workspace\java\hibernate-orm\hibernate-core\src\main\java\org\hibernate\query\criteria\internal\expression\EntityTypeExpression.java;EntityTypeExpression.java;33;4;0;4;1;1;0;1
E:\workspace\java\hibernate-orm\hibernate-core\src\main\java\org\hibernate\engine\jdbc\dialect\internal\StandardDialectResolver.java;StandardDialectResolver.java;33;10;1;9;1;1;0;1
E:\workspace\java\hibernate-orm\hibernate-core\src\main\java\org\hibernate\resource\beans\container\spi\BeanContainer.java;BeanContainer.java;33;37;35;2;1;2;0;2
E:\workspace\java\hibernate-orm\hibernate-core\src\main\java\org\hibernate\resource\transaction\backend\jdbc\spi\JdbcResourceTransaction.java;JdbcResourceTransaction.java;33;8;4;4;1;1;0;1
E:\workspace\java\hibernate-orm\hibernate-core\src\main\java\org\hibernate\cache\spi\support\CollectionReadOnlyAccess.java;CollectionReadOnlyAccess.java;33;33;33;0;1;2;0;2
E:\workspace\java\hibernate-orm\hibernate-core\src\main\java\org\hibernate\tool\hbm2ddl\ScriptExporter.java;ScriptExporter.java;33;3;3;0;1;1;0;1
E:\workspace\java\hibernate-orm\hibernate-core\src\main\java\org\hibernate\bytecode\enhance\internal\javassist\UnloadedCtField.java;UnloadedCtField.java;32;5;5;0;1;1;0;1
E:\workspace\java\hibernate-orm\hibernate-core\src\main\java\org\hibernate\dialect\identity\PostgreSQL10IdentityColumnSupport.java;PostgreSQL10IdentityColumnSupport.java;32;32;32;0;1;1;0;1
E:\workspace\java\hibernate-orm\hibernate-core\src\main\java\org\hibernate\bytecode\enhance\internal\bytebuddy\UnloadedTypeDescription.java;UnloadedTypeDescription.java;32;1;0;1;1;1;0;1
E:\workspace\java\hibernate-orm\hibernate-core\src\main\java\org\hibernate\bytecode\internal\none\NoneBasicProxyFactory.java;NoneBasicProxyFactory.java;32;32;32;0;1;1;0;1
E:\workspace\java\hibernate-orm\hibernate-envers\src\main\java\org\hibernate\envers\internal\entities\mapper\relation\query\RelationQueryGenerator.java;RelationQueryGenerator.java;31;22;15;7;1;1;1;0
E:\workspace\java\hibernate-orm\hibernate-core\src\main\java\org\hibernate\query\QueryParameter.java;QueryParameter.java;31;2;1;1;1;1;0;1
E:\workspace\java\hibernate-orm\hibernate-core\src\main\java\org\hibernate\Incubating.java;Incubating.java;30;9;8;1;1;1;0;1
E:\workspace\java\hibernate-orm\hibernate-core\src\main\java\org\hibernate\cache\spi\DirectAccessRegion.java;DirectAccessRegion.java;30;130;80;50;1;6;0;6
E:\workspace\java\hibernate-orm\hibernate-core\src\main\java\org\hibernate\service\spi\OptionallyManageable.java;OptionallyManageable.java;30;12;0;12;1;1;0;1
E:\workspace\java\hibernate-orm\hibernate-core\src\main\java\org\hibernate\query\criteria\internal\compile\CriteriaInterpretation.java;CriteriaInterpretation.java;29;4;2;2;1;1;0;1
E:\workspace\java\hibernate-orm\hibernate-core\src\main\java\org\hibernate\jpa\event\internal\EmptyCallbackBuilder.java;EmptyCallbackBuilder.java;29;29;29;0;1;1;0;1
E:\workspace\java\hibernate-orm\hibernate-core\src\main\java\org\hibernate\engine\HibernateIterator.java;HibernateIterator.java;29;3;2;1;1;1;1;0
E:\workspace\java\hibernate-orm\hibernate-core\src\main\java\org\hibernate\cache\spi\support\TimestampsRegionTemplate.java;TimestampsRegionTemplate.java;29;29;29;0;2;2;1;1
E:\workspace\java\hibernate-orm\hibernate-core\src\main\java\org\hibernate\bytecode\internal\none\NoProxyFactoryFactory.java;NoProxyFactoryFactory.java;29;29;29;0;1;1;0;1
E:\workspace\java\hibernate-orm\hibernate-core\src\main\java\org\hibernate\engine\jdbc\env\spi\SchemaNameResolver.java;SchemaNameResolver.java;29;2;1;1;1;1;0;1
E:\workspace\java\hibernate-orm\hibernate-core\src\main\java\org\hibernate\metamodel\model\convert\spi\EnumValueConverter.java;EnumValueConverter.java;29;5;3;2;1;1;0;1
E:\workspace\java\hibernate-orm\hibernate-core\src\main\java\org\hibernate\jpa\event\internal\AbstractCallback.java;AbstractCallback.java;29;6;3;3;1;1;0;1
E:\workspace\java\hibernate-orm\hibernate-core\src\main\java\org\hibernate\resource\beans\spi\BeanInstanceProducer.java;BeanInstanceProducer.java;29;29;29;0;1;1;0;1
E:\workspace\java\hibernate-orm\hibernate-core\src\main\java\org\hibernate\dialect\MariaDB10Dialect.java;MariaDB10Dialect.java;29;29;29;0;1;2;0;2
E:\workspace\java\hibernate-orm\hibernate-core\src\main\java\org\hibernate\annotations\NamedQueries.java;NamedQueries.java;29;2;1;1;1;1;0;1
E:\workspace\java\hibernate-orm\hibernate-core\src\main\java\org\hibernate\cache\spi\support\QueryResultsRegionTemplate.java;QueryResultsRegionTemplate.java;29;29;29;0;2;2;1;1
E:\workspace\java\hibernate-orm\hibernate-core\src\main\java\org\hibernate\cache\spi\access\UnknownAccessTypeException.java;UnknownAccessTypeException.java;29;6;4;2;1;1;0;1
E:\workspace\java\hibernate-orm\hibernate-jipijapa\src\main\java\org\jboss\as\jpa\hibernate5\JpaLogger.java;JpaLogger.java;29;37;33;4;1;2;0;2
E:\workspace\java\hibernate-orm\hibernate-core\src\main\java\org\hibernate\boot\spi\AdditionalJaxbMappingProducer.java;AdditionalJaxbMappingProducer.java;29;4;2;2;1;2;0;2
E:\workspace\java\hibernate-orm\hibernate-core\src\main\java\org\hibernate\internal\util\xml\XmlDocument.java;XmlDocument.java;28;8;2;6;1;1;0;1
E:\workspace\java\hibernate-orm\hibernate-envers\src\main\java\org\hibernate\envers\internal\entities\mapper\DynamicComponentMapperSupport.java;DynamicComponentMapperSupport.java;28;28;28;0;1;1;0;1
E:\workspace\java\hibernate-orm\hibernate-core\src\main\java\org\hibernate\type\PrimitiveCharacterArrayNClobType.java;PrimitiveCharacterArrayNClobType.java;28;2;1;1;1;1;0;1
E:\workspace\java\hibernate-orm\hibernate-core\src\main\java\org\hibernate\dialect\MariaDB102Dialect.java;MariaDB102Dialect.java;28;28;28;0;1;1;0;1
E:\workspace\java\hibernate-orm\hibernate-core\src\main\java\org\hibernate\metamodel\model\convert\spi\JpaAttributeConverter.java;JpaAttributeConverter.java;27;9;7;2;1;1;0;1
E:\workspace\java\hibernate-orm\hibernate-core\src\main\java\org\hibernate\boot\model\TypeContributor.java;TypeContributor.java;27;2;1;1;1;1;0;1
E:\workspace\java\hibernate-orm\hibernate-core\src\main\java\org\hibernate\cache\spi\support\DomainDataStorageAccess.java;DomainDataStorageAccess.java;27;29;28;1;1;2;0;2
E:\workspace\java\hibernate-orm\hibernate-core\src\main\java\org\hibernate\tool\schema\extract\internal\SequenceInformationExtractorMimerSQLDatabaseImpl.java;SequenceInformationExtractorMimerSQLDatabaseImpl.java;27;27;27;0;1;1;0;1
E:\workspace\java\hibernate-orm\hibernate-core\src\main\java\org\hibernate\internal\util\MathHelper.java;MathHelper.java;26;26;26;0;1;1;0;1
E:\workspace\java\hibernate-orm\hibernate-core\src\main\java\org\hibernate\cfg\annotations\ArrayBinder.java;ArrayBinder.java;26;3;2;1;1;1;0;1
E:\workspace\java\hibernate-orm\hibernate-envers\src\main\java\org\hibernate\envers\internal\entities\mapper\AbstractPropertyMapper.java;AbstractPropertyMapper.java;26;26;26;0;1;1;0;1
E:\workspace\java\hibernate-orm\hibernate-core\src\main\java\org\hibernate\bytecode\enhance\spi\interceptor\AbstractLazyLoadInterceptor.java;AbstractLazyLoadInterceptor.java;26;26;26;0;1;1;0;1
E:\workspace\java\hibernate-orm\hibernate-core\src\main\java\org\hibernate\graph\spi\AppliedGraph.java;AppliedGraph.java;26;26;26;0;1;1;0;1
E:\workspace\java\hibernate-orm\hibernate-core\src\main\java\org\hibernate\boot\spi\MetadataBuilderImplementor.java;MetadataBuilderImplementor.java;26;2;2;0;1;1;0;1
E:\workspace\java\hibernate-orm\hibernate-core\src\main\java\org\hibernate\service\spi\ServiceContributor.java;ServiceContributor.java;26;3;3;0;1;1;0;1
E:\workspace\java\hibernate-orm\hibernate-core\src\main\java\org\hibernate\resource\beans\container\spi\ContainedBeanImplementor.java;ContainedBeanImplementor.java;26;26;26;0;1;1;0;1
E:\workspace\java\hibernate-orm\hibernate-core\src\main\java\org\hibernate\cache\cfg\internal\AbstractDomainDataCachingConfig.java;AbstractDomainDataCachingConfig.java;26;26;26;0;1;1;0;1
E:\workspace\java\hibernate-orm\hibernate-core\src\main\java\org\hibernate\jpa\spi\MutableJpaCompliance.java;MutableJpaCompliance.java;26;26;26;0;1;2;0;2
E:\workspace\java\hibernate-orm\hibernate-spatial\src\main\java\org\hibernate\spatial\SpatialAggregate.java;SpatialAggregate.java;26;5;5;0;1;1;0;1
E:\workspace\java\hibernate-orm\hibernate-jipijapa\src\main\java\org\jboss\as\jpa\hibernate5\service\CustomJtaPlatformInitiator.java;CustomJtaPlatformInitiator.java;26;26;26;0;1;1;0;1
E:\workspace\java\hibernate-orm\hibernate-jcache\src\main\java\org\hibernate\cache\jcache\JCacheHelper.java;JCacheHelper.java;26;26;26;0;1;1;0;1
E:\workspace\java\hibernate-orm\hibernate-core\src\main\java\org\hibernate\hql\internal\ast\util\TokenPrinters.java;TokenPrinters.java;26;26;26;0;2;2;0;2
E:\workspace\java\hibernate-orm\hibernate-core\src\main\java\org\hibernate\bytecode\enhance\spi\interceptor\SessionAssociableInterceptor.java;SessionAssociableInterceptor.java;25;25;25;0;1;1;0;1
E:\workspace\java\hibernate-orm\hibernate-core\src\main\java\org\hibernate\boot\spi\MetadataBuilderContributor.java;MetadataBuilderContributor.java;25;25;25;0;1;1;0;1
E:\workspace\java\hibernate-orm\hibernate-core\src\main\java\org\hibernate\metamodel\model\domain\internal\ListAttributeImpl.java;ListAttributeImpl.java;25;29;27;2;1;2;0;2
E:\workspace\java\hibernate-orm\hibernate-core\src\main\java\org\hibernate\metamodel\model\domain\CollectionDomainType.java;CollectionDomainType.java;25;25;25;0;1;1;0;1
E:\workspace\java\hibernate-orm\hibernate-core\src\main\java\org\hibernate\stat\SecondLevelCacheStatistics.java;SecondLevelCacheStatistics.java;25;35;14;21;1;2;0;2
E:\workspace\java\hibernate-orm\hibernate-core\src\main\java\org\hibernate\resource\beans\container\internal\NoSuchBeanException.java;NoSuchBeanException.java;25;25;25;0;1;1;0;1
E:\workspace\java\hibernate-orm\hibernate-core\src\main\java\org\hibernate\metamodel\model\domain\internal\SetAttributeImpl.java;SetAttributeImpl.java;25;29;27;2;1;2;0;2
E:\workspace\java\hibernate-orm\hibernate-core\src\main\java\org\hibernate\resource\beans\container\spi\BeanLifecycleStrategy.java;BeanLifecycleStrategy.java;25;43;34;9;1;2;0;2
E:\workspace\java\hibernate-orm\hibernate-core\src\main\java\org\hibernate\resource\beans\spi\ManagedBean.java;ManagedBean.java;24;7;1;6;1;1;0;1
E:\workspace\java\hibernate-orm\hibernate-jipijapa\src\main\java\org\jboss\as\jpa\hibernate5\service\CustomRegionFactoryInitiator.java;CustomRegionFactoryInitiator.java;24;24;24;0;1;1;0;1
E:\workspace\java\hibernate-orm\hibernate-core\src\main\java\org\hibernate\cfg\annotations\BagBinder.java;BagBinder.java;24;2;1;1;1;1;0;1
E:\workspace\java\hibernate-orm\hibernate-core\src\main\java\org\hibernate\query\criteria\internal\Renderable.java;Renderable.java;24;60;32;28;2;2;0;2
E:\workspace\java\hibernate-orm\hibernate-core\src\main\java\org\hibernate\cache\spi\support\CacheUtils.java;CacheUtils.java;24;24;24;0;1;1;0;1
E:\workspace\java\hibernate-orm\hibernate-core\src\main\java\org\hibernate\graph\InvalidGraphException.java;InvalidGraphException.java;24;60;42;18;1;2;0;2
E:\workspace\java\hibernate-orm\hibernate-core\src\main\java\org\hibernate\graph\CannotBecomeEntityGraphException.java;CannotBecomeEntityGraphException.java;23;23;23;0;1;1;0;1
E:\workspace\java\hibernate-orm\hibernate-core\src\main\java\org\hibernate\resource\transaction\backend\jdbc\spi\JdbcResourceTransactionAccess.java;JdbcResourceTransactionAccess.java;23;2;1;1;1;1;0;1
E:\workspace\java\hibernate-orm\hibernate-core\src\main\java\org\hibernate\engine\jdbc\BlobImplementer.java;BlobImplementer.java;23;4;3;1;1;1;0;1
E:\workspace\java\hibernate-orm\hibernate-core\src\main\java\org\hibernate\metamodel\model\domain\spi\EmbeddedTypeDescriptor.java;EmbeddedTypeDescriptor.java;23;3;2;1;1;1;1;0
E:\workspace\java\hibernate-orm\hibernate-core\src\main\java\org\hibernate\service\spi\ServiceInitiator.java;ServiceInitiator.java;23;2;1;1;1;1;0;1
E:\workspace\java\hibernate-orm\hibernate-core\src\main\java\org\hibernate\type\spi\TypeConfigurationAware.java;TypeConfigurationAware.java;23;23;23;0;1;1;0;1
E:\workspace\java\hibernate-orm\hibernate-jipijapa\src\main\java\org\jboss\as\jpa\hibernate5\service\ServiceContributorImpl.java;ServiceContributorImpl.java;23;23;23;0;1;1;0;1
E:\workspace\java\hibernate-orm\hibernate-core\src\main\java\org\hibernate\tool\schema\extract\internal\SequenceInformationExtractorHSQLDBDatabaseImpl.java;SequenceInformationExtractorHSQLDBDatabaseImpl.java;23;23;23;0;1;1;0;1
E:\workspace\java\hibernate-orm\hibernate-core\src\main\java\org\hibernate\cache\cfg\spi\CollectionDataCachingConfig.java;CollectionDataCachingConfig.java;22;22;22;0;1;1;0;1
E:\workspace\java\hibernate-orm\hibernate-core\src\main\java\org\hibernate\metamodel\model\domain\PersistentAttribute.java;PersistentAttribute.java;22;22;22;0;1;1;0;1
E:\workspace\java\hibernate-orm\hibernate-core\src\main\java\org\hibernate\boot\model\source\spi\AnyMappingSource.java;AnyMappingSource.java;22;4;4;0;1;1;0;1
E:\workspace\java\hibernate-orm\hibernate-core\src\main\java\org\hibernate\graph\internal\parse\SubGraphGenerator.java;SubGraphGenerator.java;22;22;22;0;1;1;0;1
E:\workspace\java\hibernate-orm\hibernate-core\src\main\java\org\hibernate\boot\model\convert\spi\JpaAttributeConverterCreationContext.java;JpaAttributeConverterCreationContext.java;22;2;1;1;1;1;0;1
E:\workspace\java\hibernate-orm\hibernate-core\src\main\java\org\hibernate\jpa\event\spi\CallbackRegistryConsumer.java;CallbackRegistryConsumer.java;22;4;1;3;1;1;0;1
E:\workspace\java\hibernate-orm\hibernate-jipijapa\src\main\java\org\jboss\as\jpa\hibernate5\HibernateArchiveScanner.java;HibernateArchiveScanner.java;22;28;25;3;1;2;0;2
E:\workspace\java\hibernate-orm\hibernate-core\src\main\java\org\hibernate\bytecode\BytecodeLogger.java;BytecodeLogger.java;22;22;22;0;1;1;0;1
E:\workspace\java\hibernate-orm\hibernate-core\src\main\java\org\hibernate\dialect\PostgreSQL10Dialect.java;PostgreSQL10Dialect.java;21;21;21;0;1;1;0;1
E:\workspace\java\hibernate-orm\hibernate-core\src\main\java\org\hibernate\id\uuid\LocalObjectUuidHelper.java;LocalObjectUuidHelper.java;21;29;25;4;2;2;0;2
E:\workspace\java\hibernate-orm\hibernate-core\src\main\java\org\hibernate\metamodel\model\domain\EmbeddedDomainType.java;EmbeddedDomainType.java;21;21;21;0;1;1;0;1
E:\workspace\java\hibernate-orm\hibernate-envers\src\main\java\org\hibernate\envers\strategy\DefaultAuditStrategy.java;DefaultAuditStrategy.java;21;133;7;126;1;2;0;2
E:\workspace\java\hibernate-orm\hibernate-core\src\main\java\org\hibernate\cfg\annotations\PrimitiveArrayBinder.java;PrimitiveArrayBinder.java;21;3;2;1;1;1;0;1
E:\workspace\java\hibernate-orm\hibernate-core\src\main\java\org\hibernate\event\spi\PostCommitInsertEventListener.java;PostCommitInsertEventListener.java;21;2;1;1;1;1;0;1
E:\workspace\java\hibernate-orm\hibernate-core\src\main\java\org\hibernate\event\spi\PostCommitDeleteEventListener.java;PostCommitDeleteEventListener.java;21;2;1;1;1;1;0;1
E:\workspace\java\hibernate-orm\hibernate-core\src\main\java\org\hibernate\event\spi\PostCommitUpdateEventListener.java;PostCommitUpdateEventListener.java;21;2;1;1;1;1;0;1
E:\workspace\java\hibernate-orm\hibernate-core\src\main\java\org\hibernate\graph\CannotContainSubGraphException.java;CannotContainSubGraphException.java;21;21;21;0;1;1;0;1
E:\workspace\java\hibernate-orm\hibernate-core\src\main\java\org\hibernate\internal\build\AllowSysOut.java;AllowSysOut.java;20;20;20;0;1;1;0;1
E:\workspace\java\hibernate-orm\hibernate-core\src\main\java\org\hibernate\metamodel\model\domain\spi\EntityTypeDescriptor.java;EntityTypeDescriptor.java;20;4;3;1;1;1;1;0
E:\workspace\java\hibernate-orm\hibernate-core\src\main\java\org\hibernate\internal\build\AllowPrintStacktrace.java;AllowPrintStacktrace.java;20;20;20;0;1;1;0;1
E:\workspace\java\hibernate-orm\hibernate-core\src\main\java\org\hibernate\cache\spi\ExtendedStatisticsSupport.java;ExtendedStatisticsSupport.java;20;20;20;0;1;1;0;1
E:\workspace\java\hibernate-orm\hibernate-core\src\main\java\org\hibernate\graph\spi\GraphNodeImplementor.java;GraphNodeImplementor.java;20;13;7;6;1;1;0;1
E:\workspace\java\hibernate-orm\hibernate-core\src\main\java\org\hibernate\query\procedure\spi\ProcedureParameterImplementor.java;ProcedureParameterImplementor.java;20;4;4;0;1;1;0;1
E:\workspace\java\hibernate-orm\hibernate-core\src\main\java\org\hibernate\resource\beans\container\internal\NotYetReadyException.java;NotYetReadyException.java;20;20;20;0;1;1;0;1
E:\workspace\java\hibernate-orm\hibernate-spatial\src\main\java\org\hibernate\spatial\dialect\mysql\MySQL56InnoDBSpatialDialect.java;MySQL56InnoDBSpatialDialect.java;20;2;1;1;1;1;0;1
E:\workspace\java\hibernate-orm\hibernate-core\src\main\java\org\hibernate\cache\internal\NoCachingTransactionSynchronizationImpl.java;NoCachingTransactionSynchronizationImpl.java;19;19;19;0;1;1;0;1
E:\workspace\java\hibernate-orm\hibernate-core\src\main\java\org\hibernate\metamodel\model\domain\spi\MappedSuperclassTypeDescriptor.java;MappedSuperclassTypeDescriptor.java;19;4;3;1;1;1;1;0
E:\workspace\java\hibernate-orm\hibernate-spatial\src\main\java\org\hibernate\spatial\dialect\postgis\PostgisDialect.java;PostgisDialect.java;19;2;1;1;1;1;0;1
E:\workspace\java\hibernate-orm\hibernate-core\src\main\java\org\hibernate\service\spi\SessionFactoryServiceInitiatorContext.java;SessionFactoryServiceInitiatorContext.java;19;23;21;2;2;2;0;2
E:\workspace\java\hibernate-orm\hibernate-core\src\main\java\org\hibernate\service\spi\Stoppable.java;Stoppable.java;19;2;1;1;1;1;0;1
E:\workspace\java\hibernate-orm\hibernate-core\src\main\java\org\hibernate\graph\GraphNode.java;GraphNode.java;19;19;19;0;1;1;0;1
E:\workspace\java\hibernate-orm\hibernate-core\src\main\java\org\hibernate\query\CommonQueryContract.java;CommonQueryContract.java;18;2;1;1;1;1;1;0
E:\workspace\java\hibernate-orm\hibernate-core\src\main\java\org\hibernate\resource\beans\container\internal\CdiBasedBeanContainer.java;CdiBasedBeanContainer.java;18;22;20;2;1;2;0;2
E:\workspace\java\hibernate-orm\hibernate-core\src\main\java\org\hibernate\event\spi\PostLoadEventListener.java;PostLoadEventListener.java;18;2;1;1;1;1;0;1
E:\workspace\java\hibernate-orm\hibernate-core\src\main\java\org\hibernate\resource\beans\container\spi\ContainedBean.java;ContainedBean.java;18;18;18;0;1;1;0;1
E:\workspace\java\hibernate-orm\hibernate-spatial\src\main\java\org\hibernate\spatial\Spatial.java;Spatial.java;18;2;1;1;1;1;0;1
E:\workspace\java\hibernate-orm\hibernate-core\src\main\java\org\hibernate\metamodel\model\domain\MappedSuperclassDomainType.java;MappedSuperclassDomainType.java;17;17;17;0;1;1;0;1
E:\workspace\java\hibernate-orm\hibernate-core\src\main\java\org\hibernate\metamodel\model\domain\EntityDomainType.java;EntityDomainType.java;17;17;17;0;1;1;0;1
E:\workspace\java\hibernate-orm\hibernate-core\src\main\java\org\hibernate\event\service\spi\EventActionWithParameter.java;EventActionWithParameter.java;17;17;17;0;1;1;0;1
E:\workspace\java\hibernate-orm\hibernate-core\src\main\java\org\hibernate\metamodel\model\domain\IdentifiableDomainType.java;IdentifiableDomainType.java;17;17;17;0;1;1;0;1
E:\workspace\java\hibernate-orm\hibernate-core\src\main\java\org\hibernate\cache\spi\StandardCacheTransactionSynchronization.java;StandardCacheTransactionSynchronization.java;16;16;16;0;1;1;0;1
E:\workspace\java\hibernate-orm\hibernate-core\src\main\java\org\hibernate\graph\package-info.java;package-info.java;16;16;16;0;1;1;0;1
E:\workspace\java\hibernate-orm\hibernate-core\src\main\java\org\hibernate\jpa\event\internal\CallbackRegistryImplementor.java;CallbackRegistryImplementor.java;16;16;16;0;1;1;0;1
E:\workspace\java\hibernate-orm\hibernate-core\src\main\java\org\hibernate\cache\spi\QueryResultsRegion.java;QueryResultsRegion.java;16;14;7;7;1;2;0;2
E:\workspace\java\hibernate-orm\hibernate-core\src\main\java\org\hibernate\cache\cfg\spi\NaturalIdDataCachingConfig.java;NaturalIdDataCachingConfig.java;16;16;16;0;1;1;0;1
E:\workspace\java\hibernate-orm\hibernate-core\src\main\java\org\hibernate\metamodel\model\domain\ManagedDomainType.java;ManagedDomainType.java;15;15;15;0;1;1;0;1
E:\workspace\java\hibernate-orm\hibernate-core\src\main\java\org\hibernate\cache\spi\access\SoftLock.java;SoftLock.java;15;6;3;3;1;1;0;1
E:\workspace\java\hibernate-orm\hibernate-core\src\main\java\org\hibernate\metamodel\package-info.java;package-info.java;14;14;14;0;1;1;0;1
E:\workspace\java\hibernate-orm\hibernate-core\src\main\java\org\hibernate\event\spi\EntityCopyObserverFactory.java;EntityCopyObserverFactory.java;14;14;14;0;1;1;0;1
E:\workspace\java\hibernate-orm\hibernate-core\src\main\java\org\hibernate\cache\spi\TimestampsRegion.java;TimestampsRegion.java;13;19;8;11;1;3;0;3
E:\workspace\java\hibernate-orm\hibernate-core\src\main\java\org\hibernate\boot\xsd\package-info.java;package-info.java;12;12;12;0;1;1;0;1
E:\workspace\java\hibernate-orm\hibernate-vibur\src\main\java\org\hibernate\vibur\internal\package-info.java;package-info.java;11;11;11;0;1;1;0;1
E:\workspace\java\hibernate-orm\hibernate-core\src\main\java\org\hibernate\cache\cfg\package-info.java;package-info.java;11;11;11;0;1;1;0;1
E:\workspace\java\hibernate-orm\hibernate-core\src\main\java\org\hibernate\jpa\event\spi\package-info.java;package-info.java;11;13;12;1;1;2;0;2
E:\workspace\java\hibernate-orm\hibernate-core\src\main\java\org\hibernate\jpa\event\package-info.java;package-info.java;11;11;11;0;1;1;0;1
E:\workspace\java\hibernate-orm\hibernate-core\src\main\java\org\hibernate\resource\beans\container\package-info.java;package-info.java;11;11;11;0;1;1;0;1
E:\workspace\java\hibernate-orm\hibernate-agroal\src\main\java\org\hibernate\agroal\internal\package-info.java;package-info.java;11;11;11;0;1;1;0;1
E:\workspace\java\hibernate-orm\hibernate-core\src\main\java\org\hibernate\jpa\event\internal\package-info.java;package-info.java;11;13;12;1;1;2;0;2
